通開一平東端	tung
通開一平東定	dung
通開三平東知	triung
通開三平東澄	driung
通開三平東章	cjung
通開三平東徹	thriung
通開三平東崇	zriung
通開三平東心	siung
通開三平東日	njung
通開三平東見	kiung
通開三平東以	jung
通開三平東云	iung
通開三平東明	miung
通開三平東溪	khiung
通開三平東羣	giung
通開三平東並	biung
通開三平東幫	piung
通開三平東滂	phiung
通開三平東昌	chjung
通開三平東來	liung
通開一平東溪	khung
通開一平東見	kung
通開一平東明	mung
通開一平東來	lung
通開一平東匣	ghung
通開一平東從	zung
通開一平東影	qung
通開一平東清	chung
通開一平東透	thung
通開一平東精	cung
通開一平東並	bung
通開一平東曉	hung
通開一平東疑	ngung
通開一平東心	sung
通開一平冬端	tuung
通開一平冬定	duung
通開一平冬從	zuung
通開一平冬泥	nuung
通開一平冬見	kuung
通開一平冬匣	ghuung
通開一平冬來	luung
通開一平冬精	cuung
通開一平冬心	suung
通開一平冬透	thuung
通開三平鍾章	cjyung
通開三平鍾來	lyung
通開三平鍾書	sjyung
通開三平鍾邪	zsyung
通開三平鍾昌	chjyung
通開三平鍾以	jyung
通開三平鍾幫	pyung
通開三平鍾曉	hyung
通開三平鍾疑	ngyung
通開三平鍾影	qyung
通開三平鍾孃	nryung
通開三平鍾澄	dryung
通開三平鍾從	zyung
通開三平鍾徹	thryung
通開三平鍾並	byung
通開三平鍾滂	phyung
通開三平鍾精	cyung
通開三平鍾日	njyung
通開三平鍾羣	gyung
通開三平鍾常	zjyung
通開三平鍾見	kyung
通開三平鍾心	syung
通開三平鍾清	chyung
通開三平鍾溪	khyung
江開二平江見	krung
江開二平江明	mrung
江開二平江孃	nrung
江開二平江初	chrung
江開二平江幫	prung
江開二平江匣	ghrung
江開二平江滂	phrung
江開二平江來	lrung
江開二平江生	srung
江開二平江並	brung
江開二平江曉	hrung
江開二平江影	qrung
江開二平江溪	khrung
江開二平江澄	drung
江開二平江徹	thrung
江開二平江知	trung
江開二平江疑	ngrung
江開二平江崇	zrung
止開三平支章	cje
止開三平支以	je
止合三平支云	ye
止合三平支見B	kye
止合三平支曉B	hye
止合三平支影B	qye
止開三平支明B	mie
止合三平支曉A	hjye
止合三平支澄	drye
止合三平支常	zjye
止合三平支來	lye
止合三平支昌	chjye
止開三平支滂B	phie
止開三平支幫B	pie
止合三平支邪	zsye
止合三平支溪B	khye
止合三平支溪A	khjye
止開三平支羣B	gie
止開三平支羣A	gje
止開三平支曉B	hie
止開三平支溪B	khie
止開三平支疑B	ngie
止開三平支並B	bie
止開三平支常	zje
止開三平支日	nje
止開三平支來	lie
止開三平支從	zie
止開三平支精	cie
止開三平支見B	kie
止開三平支幫A	pje
止開三平支並A	bje
止開三平支書	sje
止開三平支心	sie
止開三平支初	chrie
止開三平支徹	thrie
止開三平支明A	mje
止開三平支清	chie
止開三平支知	trie
止開三平支影B	qie
止開三平支澄	drie
止合三平支心	sye
止合三平支疑B	ngye
止開三平支曉A	hje
止開三平支生	srie
止合三平支生	srye
止合三平支日	njye
止開三平支精	cie
止合三平支見A	kjye
止合三平支精	cye
止合三平支初	chrye
止合三平支知	trye
止合三平支精	cye
止開三平支昌	chje
止開三平支莊	crie
止開三平支滂A	phje
止合三平支以	jye
止開三平支崇	zrie
止開三平脂章	cjii
止開三平脂以	jii
止開三平脂生	srii
止開三平脂並A	bjii
止開三平脂精	cii
止開三平脂見A	kjii
止開三平脂昌	chjii
止開三平脂徹	thrii
止開三平脂清	chii
止開三平脂從	zii
止開三平脂孃	nrii
止開三平脂澄	drii
止開三平脂心	sii
止開三平脂書	sjii
止開三平脂羣A	gjii
止開三平脂影A	qjii
止開三平脂來	lii
止合三平脂羣A	gjyi
止合三平脂知	tryi
止合三平脂見B	kyi
止合三平脂日	njyi
止合三平脂生	sryi
止合三平脂以	jyi
止合三平脂來	lyi
止合三平脂心	syi
止合三平脂羣B	gyi
止開三平脂明B	mii
止開三平脂幫B	pii
止合三平脂章	cjyi
止合三平脂常	zjyi
止合三平脂云	yi
止開三平脂並B	bii
止開三平脂滂B	phii
止合三平脂曉A	hjyi
止合三平脂澄	dryi
止合三平脂昌	chjyi
止開三平脂知	trii
止開三平脂滂A	phjii
止合三平脂精	cyi
止合三平脂溪B	khyi
止開三平脂疑A	ngjii
止開三平脂曉A	hjii
止開三平之章	cji
止開三平之以	ji
止開三平之常	zji
止開三平之疑	ngi
止開三平之心	si
止開三平之初	chri
止開三平之羣	gi
止開三平之書	sji
止開三平之日	nji
止開三平之溪	khi
止開三平之見	ki
止開三平之邪	zsi
止開三平之來	li
止開三平之莊	cri
止開三平之曉	hi
止開三平之影	qi
止開三平之徹	thri
止開三平之澄	dri
止開三平之昌	chji
止開三平之從	zi
止開三平之精	ci
止開三平之崇	zri
止開三平之俟	zsri
止開三平之溪	khi
止開三平之書	sji
止合三平微明	myoi
止合三平微曉	hyoi
止合三平微云	yoi
止合三平微滂	phyoi
止合三平微幫	pyoi
止合三平微並	byoi
止合三平微影	qyoi
止開三平微羣	gioi
止開三平微見	kioi
止開三平微曉	hioi
止開三平微影	qioi
止開三平微疑	ngioi
止合三平微疑	ngyoi
止合三平微見	kyoi
止合三平微溪	khyoi
遇開三平魚疑	ngio
遇開三平魚初	chrio
遇開三平魚書	sjo
遇開三平魚見	kio
遇開三平魚羣	gio
遇開三平魚以	jo
遇開三平魚心	sio
遇開三平魚清	chio
遇開三平魚崇	zrio
遇開三平魚徹	thrio
遇開三平魚生	srio
遇開三平魚曉	hio
遇開三平魚邪	zsio
遇開三平魚影	qio
遇開三平魚知	trio
遇開三平魚來	lio
遇開三平魚章	cjo
遇開三平魚澄	drio
遇開三平魚日	njo
遇開三平魚精	cio
遇開三平魚溪	khio
遇開三平魚莊	crio
遇開三平魚常	zjo
遇開三平魚孃	nrio
遇合三平虞疑	ngyo
遇合三平虞初	chryo
遇合三平虞明	myo
遇合三平虞云	yo
遇合三平虞曉	hyo
遇合三平虞羣	gyo
遇合三平虞日	njyo
遇合三平虞心	syo
遇合三平虞知	tryo
遇合三平虞徹	thryo
遇合三平虞常	zjyo
遇合三平虞以	jyo
遇合三平虞溪	khyo
遇合三平虞章	cjyo
遇合三平虞清	chyo
遇合三平虞來	lyo
遇合三平虞並	byo
遇合三平虞崇	zryo
遇合三平虞莊	cryo
遇合三平虞滂	phyo
遇合三平虞精	cyo
遇合三平虞幫	pyo
遇合三平虞影	qyo
遇合三平虞書	sjyo
遇合三平虞昌	chjyo
遇合三平虞澄	dryo
遇合三平虞見	kyo
遇合三平虞生	sryo
遇開一平模明	mo
遇開一平模並	bo
遇開一平模匣	gho
遇開一平模見	ko
遇開一平模定	do
遇開一平模泥	no
遇開一平模曉	ho
遇開一平模疑	ngo
遇開一平模精	co
遇開一平模來	lo
遇開一平模心	so
遇開一平模從	zo
遇開一平模影	qo
遇開一平模幫	po
遇開一平模溪	kho
遇開一平模清	cho
遇開一平模透	tho
遇開一平模端	to
遇開一平模滂	pho
蟹開四平齊從	ze
蟹開四平齊來	le
蟹開四平齊清	che
蟹開四平齊端	te
蟹開四平齊定	de
蟹開四平齊幫	pe
蟹開四平齊見	ke
蟹開四平齊匣	ghe
蟹開四平齊影	qe
蟹開四平齊疑	nge
蟹開四平齊曉	he
蟹開四平齊心	se
蟹開四平齊透	the
蟹開四平齊並	be
蟹開四平齊滂	phe
蟹開四平齊精	ce
蟹開四平齊明	me
蟹開四平齊泥	ne
蟹開四平齊溪	khe
蟹合四平齊見	kue
蟹合四平齊溪	khue
蟹合四平齊匣	ghue
蟹開四平齊日	nj'e
蟹開四平齊常	zj'e
蟹合四平齊影	que
蟹合四平齊曉	hue
蟹開二平佳見	kre
蟹開二平佳匣	ghre
蟹開二平佳並	bre
蟹合二平佳見	krue
蟹合二平佳影	qrue
蟹合二平佳溪	khrue
蟹開二平佳崇	zre
蟹開二平佳初	chre
蟹合二平佳曉	hrue
蟹開二平佳孃	nre
蟹開二平佳疑	ngre
蟹開二平佳影	qre
蟹開二平佳生	sre
蟹開二平佳曉	hre
蟹開二平佳徹	thre
蟹開二平佳明	mre
蟹合二平佳匣	ghrue
蟹開二平皆見	krai
蟹開二平皆影	qrai
蟹開二平皆匣	ghrai
蟹開二平皆並	brai
蟹合二平皆見	kruai
蟹合二平皆匣	ghruai
蟹合二平皆溪	khruai
蟹開二平皆崇	zrai
蟹開二平皆初	chrai
蟹合二平皆曉	hruai
蟹合二平皆澄	druai
蟹開二平皆明	mrai
蟹開二平皆莊	crai
蟹合二平皆影	qruai
蟹開二平皆知	trai
蟹開二平皆來	lrai
蟹開二平皆溪	khrai
蟹開二平皆孃	nrai
蟹開二平皆生	srai
蟹開二平皆疑	ngrai
蟹開二平皆徹	thrai
蟹開二平皆曉	hrai
蟹合二平皆來	lruai
蟹合二平皆崇	zruai
蟹合一平灰曉	huai
蟹合一平灰溪	khuai
蟹合一平灰影	quai
蟹合一平灰匣	ghuai
蟹合一平灰明	muai
蟹合一平灰見	kuai
蟹合一平灰來	luai
蟹合一平灰定	duai
蟹合一平灰清	chuai
蟹合一平灰端	tuai
蟹合一平灰心	suai
蟹合一平灰從	zuai
蟹合一平灰並	buai
蟹合一平灰幫	puai
蟹合一平灰滂	phuai
蟹合一平灰疑	nguai
蟹合一平灰透	thuai
蟹合一平灰泥	nuai
蟹合一平灰精	cuai
蟹開一平咍曉	hai
蟹開一平咍溪	khai
蟹開一平咍影	qai
蟹開一平咍定	dai
蟹開一平咍見	kai
蟹開一平咍從	zai
蟹開一平咍來	lai
蟹開一平咍精	cai
蟹開一平咍清	chai
蟹開一平咍並	bai
蟹開一平咍透	thai
蟹開一平咍匣	ghai
蟹開一平咍心	sai
蟹開一平咍疑	ngai
蟹開一平咍泥	nai
蟹開一平咍端	tai
蟹開一平咍昌	chj'ai
蟹開一平咍滂	phai
臻開三平眞章	cjin
臻開三平眞徹	thrin
臻開三平眞影A	qjin
臻開三平眞心	sin
臻開三平眞常	zjin
臻開三平眞日	njin
臻開三平眞船	zsjin
臻開三平眞清	chin
臻開三平眞云	in
臻開三平眞書	sjin
臻開三平眞幫A	pjin
臻開三平眞來	lin
臻開三平眞羣B	gin
臻開三平眞知	trin
臻開三平眞澄	drin
臻開三平眞精	cin
臻開三平眞昌	chjin
臻開三平眞從	zin
臻開三平眞以	jin
臻開三平眞孃	nrin
臻開三平眞滂A	phjin
臻開三平眞並A	bjin
臻開三平眞疑B	ngin
臻開三平眞見B	kin
臻合三平眞見B	kyn
臻合三平眞云	yn
臻合三平眞溪B	khyn
臻開三平眞明B	min
臻開三平眞並B	bin
臻開三平眞影B	qin
臻合三平眞影B	qyn
臻開三平眞幫B	pin
臻開三平眞明A	mjin
臻合三平諄章	cjyn
臻合三平諄徹	thryn
臻合三平諄澄	dryn
臻合三平諄心	syn
臻合三平諄常	zjyn
臻合三平諄日	njyn
臻合三平諄船	zsjyn
臻合三平諄來	lyn
臻合三平諄知	tryn
臻合三平諄清	chyn
臻合三平諄精	cyn
臻合三平諄昌	chjyn
臻合三平諄從	zyn
臻合三平諄以	jyn
臻合三平諄邪	zsyn
臻合三平諄見	kjyn
臻開三平眞羣A	gjin
臻開三平眞滂B	phin
臻開三平臻莊	crin
臻開三平臻生	srin
臻開三平臻崇	zrin
臻合三平文明	myon
臻合三平文云	yon
臻合三平文影	qyon
臻合三平文並	byon
臻合三平文幫	pyon
臻合三平文羣	gyon
臻合三平文曉	hyon
臻合三平文見	kyon
臻合三平文滂	phyon
臻開三平欣曉	hion
臻開三平欣影	qion
臻開三平欣羣	gion
臻開三平欣見	kion
臻開三平欣疑	ngion
臻合三平元疑	ngyan
臻合三平元云	yan
臻合三平元並	byan
臻合三平元滂	phyan
臻合三平元曉	hyan
臻合三平元影	qyan
臻開三平元疑	ngian
臻開三平元溪	khian
臻開三平元曉	hian
臻開三平元見	kian
臻開三平元影	qian
臻合三平元幫	pyan
臻開三平元羣	gian
臻合三平元明	myan
臻合一平魂匣	ghuon
臻合一平魂見	kuon
臻合一平魂影	quon
臻合一平魂明	muon
臻合一平魂心	suon
臻合一平魂精	cuon
臻合一平魂從	zuon
臻合一平魂端	tuon
臻合一平魂透	thuon
臻合一平魂定	duon
臻合一平魂清	chuon
臻合一平魂疑	nguon
臻合一平魂並	buon
臻合一平魂幫	puon
臻合一平魂來	luon
臻合一平魂溪	khuon
臻合一平魂曉	huon
臻合一平魂滂	phuon
臻合一平魂泥	nuon
臻開一平痕匣	ghon
臻開一平痕見	kon
臻開一平痕影	qon
臻開一平痕透	thon
臻開一平痕疑	ngon
山開一平寒匣	ghan
山開一平寒疑	ngan
山開一平寒端	tan
山開一平寒影	qan
山開一平寒泥	nan
山開一平寒清	chan
山開一平寒透	than
山開一平寒心	san
山開一平寒定	dan
山開一平寒從	zan
山開一平寒見	kan
山開一平寒來	lan
山開一平寒溪	khan
山開一平寒曉	han
山合一平桓泥	nuan
山合一平桓匣	ghuan
山合一平桓疑	nguan
山合一平桓端	tuan
山合一平桓影	quan
山合一平桓透	thuan
山合一平桓心	suan
山合一平桓定	duan
山合一平桓從	zuan
山合一平桓見	kuan
山合一平桓來	luan
山合一平桓曉	huan
山合一平桓溪	khuan
山合一平桓精	cuan
山合一平桓並	buan
山合一平桓明	muan
山合一平桓滂	phuan
山合一平桓幫	puan
山開二平刪生	sran
山合二平刪見	kruan
山合二平刪影	qruan
山合二平刪生	sruan
山合二平刪匣	ghruan
山開二平刪幫	pran
山開二平刪明	mran
山開二平刪疑	ngran
山開二平刪見	kran
山開二平刪滂	phran
山合二平刪孃	nruan
山合二平刪疑	ngruan
山開二平刪溪	khran
山開二平刪溪	khran
山合二平刪莊	cruan
山開二平山生	sren
山合二平山見	kruen
山開二平山見	kren
山開二平山匣	ghren
山開二平山溪	khren
山開二平山崇	zren
山開二平山曉	hren
山開二平山疑	ngren
山開二平山影	qren
山開二平山幫	pren
山開二平山來	lren
山開二平山孃	nren
山開二平山昌	chj'ren
山合二平山影	qruen
山合二平山定	d'ruen
山合二平山來	lruen
山合二平山羣	gruen
山開二平山知	tren
山開二平山澄	dren
山合二平山匣	ghruen
山開二平山從	z'ren
山開四平先心	sen
山開四平先從	zen
山開四平先清	chen
山開四平先精	cen
山開四平先透	then
山開四平先見	ken
山開四平先匣	ghen
山開四平先影	qen
山開四平先來	len
山開四平先定	den
山開四平先泥	nen
山開四平先端	ten
山開四平先溪	khen
山開四平先疑	ngen
山開四平先明	men
山開四平先並	ben
山合四平先影	quen
山合四平先見	kuen
山合四平先曉	huen
山開四平先幫	pen
山合四平先匣	ghuen
山開四平先曉	hen
山合四平先崇	zr'uen
山開三平仙心	sien
山開三平仙從	zien
山開三平仙清	chien
山開三平仙精	cien
山開三平仙日	njen
山開三平仙以	jen
山開三平仙章	cjen
山開三平仙見A	kjen
山開三平仙知	trien
山開三平仙崇	zrien
山開三平仙書	sjen
山開三平仙徹	thrien
山開三平仙常	zjen
山開三平仙澄	drien
山開三平仙曉A	hjen
山開三平仙來	lien
山開三平仙滂A	phjen
山開三平仙並A	bjen
山開三平仙明A	mjen
山合三平仙從	zyen
山合三平仙心	syen
山合三平仙精	cyen
山合三平仙曉A	hjyen
山合三平仙日	njyen
山合三平仙昌	chjyen
山合三平仙以	jyen
山合三平仙邪	zsyen
山合三平仙影A	qjyen
山合三平仙船	zsjyen
山開三平仙幫A	pjen
山開三平仙邪	zsien
山合三平仙清	chyen
山合三平仙章	cjyen
山合三平仙常	zjyen
山合三平仙云	yen
山合三平仙莊	cryen
山合三平仙生	sryen
山合三平仙徹	thryen
山開三平仙羣B	gien
山開三平仙溪B	khien
山合三平仙羣B	gyen
山合三平仙澄	dryen
山合三平仙來	lyen
山合三平仙溪B	khyen
山開三平仙影B	qien
山開三平仙云	ien
山合三平仙影B	qyen
山開三平仙昌	chjen
山合三平仙知	tryen
山合三平仙見B	kyen
效開四平蕭心	seu
效開四平蕭透	theu
效開四平蕭端	teu
效開四平蕭定	deu
效開四平蕭見	keu
效開四平蕭來	leu
效開四平蕭疑	ngeu
效開四平蕭曉	heu
效開四平蕭影	qeu
效開四平蕭溪	kheu
效開三平宵心	sieu
效開三平宵徹	thrieu
效開三平宵知	trieu
效開三平宵澄	drieu
效開三平宵曉B	hieu
效開三平宵從	zieu
效開三平宵見B	kieu
效開三平宵精	cieu
效開三平宵日	njeu
效開三平宵書	sjeu
效開三平宵以	jeu
效開三平宵常	zjeu
效開三平宵章	cjeu
效開三平宵幫A	pjeu
效開三平宵幫B	pieu
效開三平宵並A	bjeu
效開三平宵明A	mjeu
效開三平宵明B	mieu
效開三平宵影A	qjeu
效開三平宵云	ieu
效開三平宵羣B	gieu
效開三平宵清	chieu
效開三平宵影B	qieu
效開三平宵溪A	khjeu
效開三平宵昌	chjeu
效開三平宵滂A	phjeu
效開三平宵羣A	gjeu
效開三平宵來	lieu
效開三平宵溪B	khieu
效開二平肴匣	ghrau
效開二平肴見	krau
效開二平肴崇	zrau
效開二平肴孃	nrau
效開二平肴生	srau
效開二平肴明	mrau
效開二平肴曉	hrau
效開二平肴幫	prau
效開二平肴滂	phrau
效開二平肴溪	khrau
效開二平肴疑	ngrau
效開二平肴莊	crau
效開二平肴知	trau
效開二平肴初	chrau
效開二平肴並	brau
效開二平肴影	qrau
效開二平肴徹	thrau
效開二平肴來	lrau
效開二平肴澄	drau
效開一平豪匣	ghau
效開一平豪見	kau
效開一平豪來	lau
效開一平豪曉	hau
效開一平豪明	mau
效開一平豪透	thau
效開一平豪端	tau
效開一平豪心	sau
效開一平豪並	bau
效開一平豪幫	pau
效開一平豪定	dau
效開一平豪精	cau
效開一平豪疑	ngau
效開一平豪從	zau
效開一平豪影	qau
效開一平豪泥	nau
效開一平豪溪	khau
效開一平豪清	chau
效開一平豪滂	phau
果開一平歌見	ka
果開一平歌清	cha
果開一平歌端	ta
果開一平歌心	sa
果開一平歌定	da
果開一平歌從	za
果開一平歌疑	nga
果開一平歌透	tha
果開一平歌來	la
果開一平歌泥	na
果開一平歌匣	gha
果開一平歌曉	ha
果開一平歌溪	kha
果開一平歌影	qa
果合一平戈見	kua
果合一平戈清	chua
果合一平戈端	tua
果合一平戈心	sua
果合一平戈並	bua
果合一平戈定	dua
果合一平戈明	mua
果合一平戈從	zua
果合一平戈疑	ngua
果合一平戈透	thua
果合一平戈來	lua
果合一平戈泥	nua
果合一平戈幫	pua
果合一平戈滂	phua
果合一平戈匣	ghua
果合一平戈溪	khua
果合一平戈影	qua
果合三平戈曉	hya
果合三平戈影	qya
果合三平戈溪	khya
果開三平戈羣	gia
果開三平戈溪	khia
果開三平戈見	kia
果合三平戈清	chya
果合三平戈精	cya
果合三平戈羣	gya
果合三平戈來	lya
假開二平麻明	mra
假開三平麻昌	chja
假開三平麻書	sja
假開三平麻以	ja
假開三平麻章	cja
假開三平麻精	cia
假開三平麻船	zsja
假合二平麻匣	ghrua
假合二平麻見	krua
假合二平麻曉	hrua
假合二平麻溪	khrua
假開二平麻孃	nra
假開二平麻見	kra
假開二平麻匣	ghra
假開二平麻滂	phra
假開二平麻影	qra
假開二平麻幫	pra
假開二平麻初	chra
假開二平麻生	sra
假開二平麻疑	ngra
假開二平麻莊	cra
假開二平麻澄	dra
假開三平麻邪	zsia
假開三平麻常	zja
假合二平麻影	qrua
假合二平麻莊	crua
假合二平麻知	trua
假開二平麻並	bra
假開二平麻崇	zra
假開二平麻徹	thra
假開二平麻知	tra
假開二平麻曉	hra
假開二平麻溪	khra
假開三平麻從	zia
假開三平麻日	nja
假開三平麻心	sia
假開三平麻知	tria
假合二平麻疑	ngrua
假開二平麻溪	khra
宕開三平陽以	jang
宕開三平陽邪	zsiang
宕開三平陽來	liang
宕開三平陽曉	hiang
宕開三平陽書	sjang
宕合三平陽並	byang
宕開三平陽章	cjang
宕開三平陽昌	chjang
宕開三平陽溪	khiang
宕開三平陽見	kiang
宕開三平陽澄	driang
宕開三平陽知	triang
宕開三平陽日	njang
宕合三平陽幫	pyang
宕開三平陽心	siang
宕開三平陽精	ciang
宕開三平陽初	chriang
宕合三平陽明	myang
宕開三平陽孃	nriang
宕開三平陽崇	zriang
宕開三平陽莊	criang
宕開三平陽常	zjang
宕開三平陽生	sriang
宕開三平陽從	ziang
宕開三平陽清	chiang
宕合三平陽溪	khyang
宕合三平陽云	yang
宕開三平陽影	qiang
宕開三平陽羣	giang
宕開三平陽徹	thriang
宕合三平陽滂	phyang
宕合三平陽羣	gyang
宕開一平唐定	dang
宕開一平唐來	lang
宕開一平唐端	tang
宕開一平唐清	chang
宕開一平唐見	kang
宕開一平唐心	sang
宕開一平唐溪	khang
宕合一平唐曉	huang
宕合一平唐匣	ghuang
宕合一平唐見	kuang
宕開一平唐透	thang
宕開一平唐滂	phang
宕合一平唐影	quang
宕開一平唐影	qang
宕開一平唐曉	hang
宕開一平唐匣	ghang
宕開一平唐明	mang
宕開一平唐精	cang
宕開一平唐泥	nang
宕開一平唐並	bang
宕開一平唐疑	ngang
宕開一平唐從	zang
宕合一平唐溪	khuang
宕開一平唐幫	pang
梗開二平庚見	krang
梗開二平庚溪	khrang
梗開二平庚明	mrang
梗合二平庚匣	ghruang
梗開二平庚幫	prang
梗合二平庚曉	hruang
梗合二平庚見	kruang
梗開二平庚並	brang
梗開二平庚曉	hrang
梗開二平庚徹	thrang
梗開二平庚初	chrang
梗開二平庚崇	zrang
梗開三平庚影	qieng
梗開三平庚滂	phieng
梗開三平庚並	bieng
梗開三平庚見	kieng
梗開三平庚明	mieng
梗開二平庚澄	drang
梗開二平庚知	trang
梗合三平庚云	yeng
梗開三平庚幫	pieng
梗合三平庚曉	hyeng
梗開三平庚溪	khieng
梗開二平庚生	srang
梗開三平庚羣	gieng
梗開三平庚疑	ngieng
梗開二平庚匣	ghrang
梗開二平庚孃	nrang
梗開二平耕見	kreng
梗開二平耕溪	khreng
梗開二平耕明	mreng
梗開二平耕幫	preng
梗合二平耕匣	ghrueng
梗開二平耕匣	ghreng
梗開二平耕知	treng
梗開二平耕影	qreng
梗開二平耕崇	zreng
梗開二平耕初	chreng
梗開二平耕孃	nreng
梗開二平耕滂	phreng
梗合二平耕曉	hrueng
梗開二平耕幫	preng
梗開二平耕澄	dreng
梗合二平耕影	qrueng
梗開二平耕並	breng
梗開二平耕疑	ngreng
梗開二平耕莊	creng
梗開三平清清	chieng
梗開三平清從	zieng
梗開三平清精	cieng
梗開三平清以	jeng
梗合三平清以	jyeng
梗開三平清影	qjeng
梗開三平清知	trieng
梗開三平清徹	thrieng
梗開三平清常	zjeng
梗開三平清澄	drieng
梗開三平清書	sjeng
梗開三平清章	cjeng
梗開三平清溪	khjeng
梗開三平清明	mjeng
梗開三平清來	lieng
梗開三平清幫	pjeng
梗合三平清溪	khjyeng
梗開三平清邪	zsieng
梗合三平清影	qjyeng
梗合三平清羣	gjyeng
梗合三平清心	syeng
梗開三平清羣	gjeng
梗合三平清曉	hjyeng
梗開四平青清	cheng
梗開四平青見	keng
梗開四平青匣	gheng
梗開四平青定	deng
梗開四平青端	teng
梗開四平青曉	heng
梗開四平青心	seng
梗開四平青滂	pheng
梗開四平青來	leng
梗開四平青泥	neng
梗開四平青透	theng
梗開四平青明	meng
梗開四平青並	beng
梗合四平青匣	ghueng
梗合四平青見	kueng
曾開三平蒸章	cjing
曾開三平蒸常	zjing
曾開三平蒸澄	dring
曾開三平蒸來	ling
曾開三平蒸影	qing
曾開三平蒸並	bing
曾開三平蒸幫	ping
曾開三平蒸以	jing
曾開三平蒸船	zsjing
曾開三平蒸書	sjing
曾開三平蒸日	njing
曾開三平蒸見	king
曾開三平蒸知	tring
曾開三平蒸從	zing
曾開三平蒸疑	nging
曾開三平蒸曉	hing
曾開三平蒸昌	chjing
曾開三平蒸羣	ging
曾開三平蒸生	sring
曾開三平蒸溪	khing
曾開三平蒸徹	thring
曾開三平蒸崇	zring
曾開三平蒸滂	phing
曾開一平登端	tong
曾開一平登來	long
曾開一平登心	song
曾開一平登幫	pong
曾開一平登精	cong
曾開一平登明	mong
曾開一平登從	zong
曾開一平登並	bong
曾合一平登匣	ghuong
曾合一平登見	kuong
曾合一平登曉	huong
曾開一平登泥	nong
曾開一平登定	dong
曾開一平登匣	ghong
曾開一平登見	kong
曾開一平登透	thong
曾開一平登滂	phong
流開三平尤云	iu
流開三平尤影	qiu
流開三平尤來	liu
流開三平尤清	chiu
流開三平尤以	ju
流開三平尤疑	ngiu
流開三平尤精	ciu
流開三平尤從	ziu
流開三平尤心	siu
流開三平尤徹	thriu
流開三平尤溪	khiu
流開三平尤昌	chju
流開三平尤章	cju
流開三平尤常	zju
流開三平尤日	nju
流開三平尤書	sju
流開三平尤溪	khiu
流開三平尤滂	phiu
流開三平尤見	kiu
流開三平尤幫	piu
流開三平尤生	sriu
流開三平尤初	chriu
流開三平尤莊	criu
流開三平尤崇	zriu
流開三平尤曉	hiu
流開三平尤邪	zsiu
流開三平尤澄	driu
流開三平尤知	triu
流開三平尤羣	giu
流開三平尤並	biu
流開三平尤明	miu
流開一平侯匣	ghu
流開一平侯影	qu
流開一平侯泥	nu
流開一平侯來	lu
流開一平侯心	su
流開一平侯溪	khu
流開一平侯曉	hu
流開一平侯精	cu
流開一平侯透	thu
流開一平侯定	du
流開一平侯疑	ngu
流開一平侯見	ku
流開一平侯端	tu
流開一平侯從	zu
流開一平侯並	bu
流開一平侯清	chu
流開一平侯明	mu
流開三平幽影	qy
流開三平幽羣	gy
流開三平幽幫	py
流開三平幽來	ly
流開三平幽見	ky
流開三平幽並	by
流開三平幽精	cy
流開三平幽生	sry
流開三平幽疑	ngy
流開三平幽曉	hy
流開三平幽明	my
深開三平侵清	chim
深開三平侵邪	zsim
深開三平侵來	lim
深開三平侵徹	thrim
深開三平侵章	cjim
深開三平侵澄	drim
深開三平侵知	trim
深開三平侵常	zjim
深開三平侵日	njim
深開三平侵書	sjim
深開三平侵以	jim
深開三平侵心	sim
深開三平侵影A	qjim
深開三平侵精	cim
深開三平侵從	zim
深開三平侵孃	nrim
深開三平侵羣B	gim
深開三平侵溪B	khim
深開三平侵疑B	ngim
深開三平侵曉B	him
深開三平侵見B	kim
深開三平侵影B	qim
深開三平侵生	srim
深開三平侵崇	zrim
深開三平侵莊	crim
深開三平侵初	chrim
深開三平侵昌	chjim
咸開一平覃定	dom
咸開一平覃清	chom
咸開一平覃泥	nom
咸開一平覃影	qom
咸開一平覃匣	ghom
咸開一平覃來	lom
咸開一平覃從	zom
咸開一平覃精	com
咸開一平覃透	thom
咸開一平覃端	tom
咸開一平覃溪	khom
咸開一平覃曉	hom
咸開一平覃心	som
咸開一平覃見	kom
咸開一平覃疑	ngom
咸開一平談定	dam
咸開一平談見	kam
咸開一平談端	tam
咸開一平談心	sam
咸開一平談來	lam
咸開一平談溪	kham
咸開一平談透	tham
咸開一平談從	zam
咸開一平談匣	gham
咸開一平談明	mam
咸開一平談從	zam
咸開一平談曉	ham
咸開三平鹽以	jem
咸開三平鹽來	liem
咸開三平鹽幫B	piem
咸開三平鹽心	siem
咸開三平鹽清	chiem
咸開三平鹽章	cjem
咸開三平鹽常	zjem
咸開三平鹽書	sjem
咸開三平鹽昌	chjem
咸開三平鹽日	njem
咸開三平鹽孃	nriem
咸開三平鹽云	iem
咸開三平鹽知	triem
咸開三平鹽徹	thriem
咸開三平鹽影B	qiem
咸開三平鹽溪B	khiem
咸開三平鹽疑B	ngiem
咸開三平鹽精	ciem
咸開三平鹽從	ziem
咸開三平鹽羣B	giem
咸開三平鹽影A	qjem
咸開三平鹽邪	zsiem
咸開三平鹽生	sriem
咸開三平鹽澄	driem
咸開三平鹽羣A	gjem
咸開四平添透	them
咸開四平添端	tem
咸開四平添定	dem
咸開四平添來	lem
咸開四平添溪	khem
咸開四平添見	kem
咸開四平添匣	ghem
咸開四平添泥	nem
咸開四平添曉	hem
咸開二平咸匣	ghrem
咸開二平咸見	krem
咸開二平咸生	srem
咸開二平咸影	qrem
咸開二平咸疑	ngrem
咸開二平咸曉	hrem
咸開二平咸知	trem
咸開二平咸孃	nrem
咸開二平咸崇	zrem
咸開二平咸溪	khrem
咸開二平銜匣	ghram
咸開二平銜崇	zram
咸開二平銜疑	ngram
咸開二平銜初	chram
咸開二平銜生	sram
咸開二平銜見	kram
咸開二平銜並	bram
咸開二平銜溪	khram
咸開三平嚴疑	ngiam
咸開三平嚴曉	hiam
咸開三平嚴影	qiam
咸開三平嚴溪	khiam
咸合三平凡並	byam
咸合三平凡滂	phyam
通開一上東端	tungx
通開一上東明	mungx
通開一上東溪	khungx
通開一上東心	sungx
通開一上東透	thungx
通開一上東精	cungx
通開一上東匣	ghungx
通開一上東影	qungx
通開一上東泥	nungx
通開一上東幫	pungx
通開一上東來	lungx
通開一上東曉	hungx
通開一上東定	dungx
通開一上東並	bungx
通開三上鍾章	cjyungx
通開三上鍾徹	thryungx
通開三上鍾來	lyungx
通開三上鍾影	qyungx
通開三上鍾日	njyungx
通開三上鍾澄	dryungx
通開三上鍾知	tryungx
通開三上鍾並	byungx
通開三上鍾滂	phyungx
通開三上鍾以	jyungx
通開三上鍾溪	khyungx
通開三上鍾常	zjyungx
通開三上鍾見	kyungx
通開三上鍾心	syungx
通開三上鍾曉	hyungx
通開三上鍾幫	pyungx
通開一上冬端	tuungx
通開一上冬明	muungx
通開三上鍾羣	gyungx
通開三上鍾昌	chjyungx
通開三上鍾章	cjyungx
通開三上鍾精	cyungx
江開二上江見	krungx
江開二上江並	brungx
江開二上江影	qrungx
江開二上江明	mrungx
江開二上江匣	ghrungx
江開二上江幫	prungx
江開二上江曉	hrungx
止開三上支章	cjex
止開三上支常	zjex
止開三上支明B	miex
止開三上支幫B	piex
止開三上支並B	biex
止合三上支曉B	hyex
止合三上支影B	qyex
止合三上支溪B	khyex
止合三上支見B	kyex
止合三上支心	syex
止合三上支來	lyex
止開三上支羣B	giex
止開三上支影B	qiex
止開三上支見B	kiex
止開三上支溪B	khiex
止開三上支疑B	ngiex
止合三上支云	yex
止合三上支精	cyex
止合三上支日	njyex
止開三上支清	chiex
止開三上支澄	driex
止開三上支心	siex
止開三上支以	jex
止開三上支來	liex
止開三上支生	sriex
止開三上支幫A	pjex
止開三上支日	njex
止開三上支明A	mjex
止開三上支並A	bjex
止開三上支昌	chjex
止開三上支書	sjex
止開三上支精	ciex
止合三上支章	cjyex
止合三上支初	chryex
止合三上支邪	zsyex
止開三上支船	zsjex
止開三上支莊	criex
止開三上支滂B	phiex
止開三上支滂A	phjex
止合三上支以	jyex
止合三上支從	zyex
止合三上支溪A	khjyex
止開三上支孃	nriex
止合三上支疑B	ngyex
止合三上支羣B	gyex
止開三上支徹	thriex
止開三上支知	triex
止開三上支曉B	hiex
止開三上支溪A	khjex
止合三上支常	zjyex
止開三上支見A	kjex
止開三上脂章	cjiix
止開三上脂常	zjiix
止開三上脂明B	miix
止開三上脂幫B	piix
止開三上脂邪	zsiix
止開三上脂見A	kjiix
止開三上脂精	ciix
止開三上脂幫A	pjiix
止合三上脂見B	kyix
止合三上脂云	yix
止開三上脂書	sjiix
止開三上脂澄	driix
止開三上脂心	siix
止開三上脂並A	bjiix
止開三上脂來	liix
止合三上脂書	sjyix
止合三上脂來	lyix
止合三上脂羣A	gjyix
止合三上脂清	chyix
止開三上脂孃	nriix
止合三上脂見A	kjyix
止開三上脂並B	biix
止合三上脂從	zyix
止開三上脂滂B	phiix
止合三上脂日	njyix
止合三上脂以	jyix
止開三上脂影A	qjiix
止合三上脂精	cyix
止開三上脂知	triix
止開三上脂徹	thriix
止開三上脂章	cjiix
止合三上脂曉A	hjyix
止合三上脂羣B	gyix
止開三上脂羣A	gjiix
止合三上脂溪B	khyix
止開三上之章	cjix
止開三上之常	zjix
止開三上之知	trix
止開三上之曉	hix
止開三上之見	kix
止開三上之以	jix
止開三上之邪	zsix
止開三上之生	srix
止開三上之日	njix
止開三上之來	lix
止開三上之心	six
止開三上之書	sjix
止開三上之澄	drix
止開三上之溪	khix
止開三上之崇	zrix
止開三上之俟	zsrix
止開三上之精	cix
止開三上之云	ix
止開三上之疑	ngix
止開三上之昌	chjix
止開三上之徹	thrix
止開三上之初	chrix
止開三上之莊	crix
止開三上之影	qix
止開三上之孃	nrix
止合三上微明	myoix
止開三上微影	qioix
止開三上微溪	khioix
止開三上微見	kioix
止合三上微滂	phyoix
止合三上微幫	pyoix
止合三上微云	yoix
止合三上微見	kyoix
止合三上微曉	hyoix
止開三上微疑	ngioix
止開三上微曉	hioix
止合三上微影	qyoix
止合三上微並	byoix
遇開三上魚疑	ngiox
遇開三上魚來	liox
遇開三上魚澄	driox
遇開三上魚以	jox
遇開三上魚章	cjox
遇開三上魚日	njox
遇開三上魚書	sjox
遇開三上魚昌	chjox
遇開三上魚知	triox
遇開三上魚心	siox
遇開三上魚徹	thriox
遇開三上魚孃	nriox
遇開三上魚曉	hiox
遇開三上魚羣	giox
遇開三上魚生	sriox
遇開三上魚初	chriox
遇開三上魚莊	criox
遇開三上魚崇	zriox
遇開三上魚從	ziox
遇開三上魚影	qiox
遇開三上魚見	kiox
遇開三上魚邪	zsiox
遇開三上魚溪	khiox
遇開三上魚船	zsjox
遇開三上魚常	zjox
遇開三上魚清	chiox
遇開三上魚精	ciox
遇合三上虞疑	ngyox
遇合三上虞云	yox
遇合三上虞從	zyox
遇合三上虞幫	pyox
遇合三上虞明	myox
遇合三上虞並	byox
遇合三上虞滂	phyox
遇合三上虞澄	dryox
遇合三上虞曉	hyox
遇合三上虞常	zjyox
遇合三上虞以	jyox
遇合三上虞章	cjyox
遇合三上虞影	qyox
遇合三上虞溪	khyox
遇合三上虞知	tryox
遇合三上虞日	njyox
遇合三上虞羣	gyox
遇合三上虞生	sryox
遇合三上虞見	kyox
遇合三上虞清	chyox
遇合三上虞來	lyox
遇合三上虞心	syox
遇合三上虞崇	zryox
遇開一上模明	mox
遇開一上模透	thox
遇開一上模定	dox
遇開一上模來	lox
遇開一上模清	chox
遇開一上模端	tox
遇開一上模見	kox
遇開一上模疑	ngox
遇開一上模並	box
遇開一上模從	zox
遇開一上模精	cox
遇開一上模曉	hox
遇開一上模影	qox
遇開一上模溪	khox
遇開一上模泥	nox
遇開一上模匣	ghox
遇開一上模滂	phox
遇開一上模幫	pox
蟹開四上齊從	zex
蟹開四上齊來	lex
蟹開四上齊透	thex
蟹開四上齊滂	phex
蟹開四上齊精	cex
蟹開四上齊端	tex
蟹開四上齊定	dex
蟹開四上齊泥	nex
蟹開四上齊心	sex
蟹開四上齊清	chex
蟹開四上齊溪	khex
蟹開四上齊曉	hex
蟹開四上齊明	mex
蟹開四上齊並	bex
蟹開四上齊影	qex
蟹開四上齊疑	ngex
蟹開四上齊幫	pex
蟹開二上佳匣	ghrex
蟹開二上佳明	mrex
蟹開二上佳溪	khrex
蟹開二上佳澄	drex
蟹開二上佳孃	nrex
蟹開二上佳並	brex
蟹開二上佳影	qrex
蟹開二上佳幫	prex
蟹開二上佳見	krex
蟹開二上佳生	srex
蟹合二上佳見	kruex
蟹合二上佳澄	druex
蟹合二上佳匣	ghruex
蟹合二上佳曉	hruex
蟹開二上佳羣	grex
蟹開二上皆匣	ghraix
蟹開二上皆溪	khraix
蟹開二上皆疑	ngraix
蟹開二上皆影	qraix
蟹合一上灰曉	huaix
蟹合一上灰影	quaix
蟹合一上灰來	luaix
蟹合一上灰定	duaix
蟹合一上灰從	zuaix
蟹合一上灰明	muaix
蟹合一上灰透	thuaix
蟹合一上灰匣	ghuaix
蟹合一上灰溪	khuaix
蟹合一上灰端	tuaix
蟹合一上灰泥	nuaix
蟹合一上灰知	tr'uaix
蟹合一上灰疑	nguaix
蟹合一上灰清	chuaix
蟹合一上灰並	buaix
蟹合一上灰精	cuaix
蟹合一上灰云	i'uaix
蟹開一上咍曉	haix
蟹開一上咍溪	khaix
蟹開一上咍精	caix
蟹開一上咍定	daix
蟹開一上咍泥	naix
蟹開一上咍見	kaix
蟹開一上咍匣	ghaix
蟹開一上咍滂	phaix
蟹開一上咍清	chaix
蟹開一上咍昌	chj'aix
蟹開一上咍端	taix
蟹開一上咍明	maix
蟹開一上咍從	zaix
蟹開一上咍滂	phaix
蟹開一上咍影	qaix
蟹開一上咍以	j'aix
蟹開一上咍透	thaix
蟹開一上咍日	nj'aix
蟹開一上咍來	laix
蟹開一上咍以	j'aix
蟹開一上咍並	baix
臻開三上眞章	cjinx
臻開三上眞徹	thrinx
臻開三上眞常	zjinx
臻開三上眞日	njinx
臻開三上眞書	sjinx
臻開三上眞來	linx
臻開三上眞澄	drinx
臻開三上眞見A	kjinx
臻開三上眞從	zinx
臻開三上眞精	cinx
臻開三上眞並A	bjinx
臻開三上眞疑A	ngjinx
臻開三上眞清	chinx
臻合三上眞羣B	gynx
臻開三上眞以	jinx
臻開三上眞明B	minx
臻開三上眞明A	mjinx
臻合三上眞云	ynx
臻合三上諄章	cjynx
臻合三上諄以	jynx
臻合三上諄心	synx
臻合三上諄日	njynx
臻合三上諄昌	chjynx
臻合三上諄船	zsjynx
臻合三上諄徹	thrynx
臻合三上諄來	lynx
臻合三上諄日	njynx
臻合三上諄溪	khjynx
臻開三上眞溪A	khjinx
臻合三上諄書	sjynx
臻開三上眞曉A	hjinx
臻開三上眞崇	zrinx
臻開三上眞知	trinx
臻合三上文明	myonx
臻合三上文幫	pyonx
臻合三上文並	byonx
臻合三上文滂	phyonx
臻合三上文影	qyonx
臻合三上文疑	ngyonx
臻合三上文云	yonx
臻合三上文溪	khyonx
臻開三上欣影	qionx
臻開三上欣見	kionx
臻開三上臻莊	crinx
臻開三上欣溪	khionx
臻開三上欣羣	gionx
臻開三上臻初	chrinx
臻開三上欣疑	ngionx
臻開三上欣曉	hionx
臻合三上元疑	ngyanx
臻合三上元云	yanx
臻開三上元影	qianx
臻開三上元見	kianx
臻開三上元羣	gianx
臻開三上元溪	khianx
臻開三上元疑	ngianx
臻開三上元曉	hianx
臻合三上元明	myanx
臻合三上元幫	pyanx
臻合三上元羣	gyanx
臻合三上元影	qyanx
臻合三上元溪	khyanx
臻合三上元曉	hyanx
臻合三上元並	byanx
臻合一上魂匣	ghuonx
臻合一上魂滂	phuonx
臻合一上魂清	chuonx
臻合一上魂幫	puonx
臻合一上魂心	suonx
臻合一上魂精	cuonx
臻合一上魂影	quonx
臻合一上魂定	duonx
臻合一上魂從	zuonx
臻合一上魂見	kuonx
臻合一上魂透	thuonx
臻合一上魂溪	khuonx
臻合一上魂來	luonx
臻合一上魂並	buonx
臻合一上魂明	muonx
臻合一上魂泥	nuonx
臻合一上魂曉	huonx
臻開一上痕匣	ghonx
臻開一上痕溪	khonx
臻開一上痕見	konx
山開一上寒匣	ghanx
山開一上寒端	tanx
山開一上寒透	thanx
山開一上寒心	sanx
山開一上寒定	danx
山開一上寒從	zanx
山開一上寒見	kanx
山開一上寒來	lanx
山開一上寒溪	khanx
山開一上寒曉	hanx
山開一上寒精	canx
山合一上桓匣	ghuanx
山合一上桓端	tuanx
山合一上桓影	quanx
山合一上桓透	thuanx
山合一上桓心	suanx
山合一上桓見	kuanx
山合一上桓來	luanx
山合一上桓溪	khuanx
山合一上桓泥	nuanx
山合一上桓精	cuanx
山合一上桓並	buanx
山合一上桓明	muanx
山合一上桓幫	puanx
山合一上桓邪	zsuanx
山合一上桓定	duanx
山開一上寒泥	nanx
山合一上桓滂	phuanx
山開二上刪生	sranx
山合二上刪影	qruanx
山開二上刪幫	pranx
山開二上刪莊	cranx
山開二上刪孃	nranx
山開二上刪匣	ghranx
山合二上刪匣	ghruanx
山開二上刪並	branx
山開二上刪明	mranx
山開二上刪崇	zranx
山開二上刪疑	ngranx
山開二上刪初	chranx
山開二上刪滂	phranx
山合二上刪崇	zruanx
山開二上山生	srenx
山開二上山匣	ghrenx
山開二上山明	mrenx
山開二上山見	krenx
山開二上山初	chrenx
山開二上山崇	zrenx
山開二上山疑	ngrenx
山開二上山莊	crenx
山合二上山初	chruenx
山開二上山溪	khrenx
山開四上先心	senx
山開四上先透	thenx
山開四上先端	tenx
山開四上先影	qenx
山開四上先定	denx
山開四上先見	kenx
山開四上先匣	ghenx
山開四上先曉	henx
山開四上先明	menx
山開四上先泥	nenx
山開四上先幫	penx
山合四上先匣	ghuenx
山合四上先見	kuenx
山開四上先並	benx
山合四上先溪	khuenx
山開四上先溪	khenx
山開四上先疑	ngenx
山開三上仙心	sienx
山開三上仙以	jenx
山開三上仙從	zienx
山開三上仙知	trienx
山開三上仙章	cjenx
山開三上仙孃	nrienx
山開三上仙清	chienx
山開三上仙昌	chjenx
山開三上仙溪A	khjenx
山開三上仙見B	kienx
山開三上仙常	zjenx
山開三上仙精	cienx
山開三上仙日	njenx
山開三上仙邪	zsienx
山開三上仙來	lienx
山開三上仙疑B	ngienx
山開三上仙羣B	gienx
山開三上仙並B	bienx
山開三上仙明A	mjenx
山開三上仙幫A	pjenx
山合三上仙精	cyenx
山合三上仙從	zyenx
山開三上仙幫B	pienx
山合三上仙以	jyenx
山合三上仙來	lyenx
山合三上仙知	tryenx
山合三上仙見B	kyenx
山合三上仙羣B	gyenx
山合三上仙日	njyenx
山合三上仙昌	chjyenx
山合三上仙常	zjyenx
山合三上仙澄	dryenx
山合三上仙章	cjyenx
山合三上仙心	syenx
山合三上仙崇	zryenx
山合三上仙羣A	gjyenx
山合三上仙曉A	hjyenx
山開三上仙並A	bjenx
山開三上仙明B	mienx
山開三上仙徹	thrienx
山開三上仙滂B	phienx
山開三上仙書	sjenx
山開三上仙影B	qienx
山開三上仙澄	drienx
山開三上仙崇	zrienx
效開四上蕭心	seux
效開四上蕭見	keux
效開四上蕭端	teux
效開四上蕭來	leux
效開四上蕭透	theux
效開四上蕭曉	heux
效開四上蕭影	qeux
效開四上蕭泥	neux
效開四上蕭匣	gheux
效開四上蕭定	deux
效開四上蕭溪	kheux
效開四上蕭精	ceux
效開三上宵心	sieux
效開三上宵澄	drieux
效開三上宵章	cjeux
效開三上宵影B	qieux
效開三上宵徹	thrieux
效開三上宵書	sjeux
效開三上宵日	njeux
效開三上宵並A	bjeux
效開三上宵昌	chjeux
效開三上宵滂A	phjeux
效開三上宵明A	mjeux
效開三上宵常	zjeux
效開三上宵見B	kieux
效開三上宵幫B	pieux
效開三上宵幫A	pjeux
效開三上宵並B	bieux
效開三上宵以	jeux
效開三上宵清	chieux
效開三上宵精	cieux
效開三上宵羣B	gieux
效開三上宵來	lieux
效開三上宵滂B	phieux
效開三上宵影A	qjeux
效開二上肴溪	khraux
效開二上肴匣	ghraux
效開二上肴幫	praux
效開二上肴孃	nraux
效開二上肴明	mraux
效開二上肴見	kraux
效開二上肴莊	craux
效開二上肴影	qraux
效開二上肴並	braux
效開二上肴疑	ngraux
效開二上肴崇	zraux
效開二上肴初	chraux
效開二上肴知	traux
效開二上肴生	sraux
效開一上豪匣	ghaux
效開一上豪並	baux
效開一上豪來	laux
效開一上豪透	thaux
效開一上豪定	daux
效開一上豪泥	naux
效開一上豪心	saux
效開一上豪端	taux
效開一上豪清	chaux
效開一上豪精	caux
效開一上豪從	zaux
效開一上豪見	kaux
效開一上豪曉	haux
效開一上豪明	maux
效開一上豪幫	paux
效開一上豪影	qaux
效開一上豪溪	khaux
效開一上豪疑	ngaux
果開一上歌見	kax
果開一上歌清	chax
果開一上歌端	tax
果開一上歌心	sax
果開一上歌定	dax
果開一上歌疑	ngax
果開一上歌透	thax
果開一上歌來	lax
果開一上歌泥	nax
果開一上歌匣	ghax
果開一上歌曉	hax
果開一上歌溪	khax
果開一上歌影	qax
果開一上歌精	cax
果合一上戈見	kuax
果合一上戈端	tuax
果合一上戈心	suax
果合一上戈定	duax
果合一上戈透	thuax
果合一上戈明	muax
果合一上戈從	zuax
果合一上戈疑	nguax
果合一上戈來	luax
果合一上戈影	quax
果合一上戈泥	nuax
果合一上戈幫	puax
果合一上戈滂	phuax
果合一上戈匣	ghuax
果合一上戈曉	huax
果合一上戈溪	khuax
果開一上歌並	bax
果合一上戈清	chuax
果合一上戈精	cuax
假開二上麻明	mrax
假開三上麻章	cjax
假開三上麻以	jax
假開二上麻疑	ngrax
假開二上麻見	krax
假開二上麻生	srax
假開二上麻影	qrax
假開三上麻邪	zsiax
假開二上麻匣	ghrax
假開三上麻心	siax
果合三上戈精	cyax
假開三上麻明	mjax
假開三上麻清	chiax
假開二上麻曉	hrax
假開三上麻常	zjax
假開二上麻溪	khrax
假開二上麻並	brax
假開三上麻書	sjax
假開三上麻精	ciax
假開二上麻幫	prax
假合二上麻匣	ghruax
假合二上麻見	kruax
假合二上麻疑	ngruax
假開三上麻日	njax
假開二上麻莊	crax
假開二上麻知	trax
假開二上麻崇	zrax
假開三上麻昌	chjax
假開二上麻知	trax
假開二上麻孃	nrax
假合二上麻溪	khruax
假合二上麻初	chruax
假合二上麻徹	thruax
假合二上麻生	sruax
假開二上麻徹	thrax
假開二上麻來	lrax
宕開三上陽以	jangx
宕開三上陽邪	zsiangx
宕開三上陽精	ciangx
宕開三上陽來	liangx
宕開三上陽影	qiangx
宕開三上陽羣	giangx
宕開三上陽疑	ngiangx
宕開三上陽初	chriangx
宕開三上陽心	siangx
宕開三上陽章	cjangx
宕開三上陽生	sriangx
宕開三上陽曉	hiangx
宕開三上陽昌	chjangx
宕開三上陽見	kiangx
宕開三上陽澄	driangx
宕開三上陽徹	thriangx
宕合三上陽見	kyangx
宕開三上陽日	njangx
宕開三上陽書	sjangx
宕合三上陽滂	phyangx
宕合三上陽明	myangx
宕合三上陽幫	pyangx
宕合三上陽影	qyangx
宕合三上陽云	yangx
宕合三上陽曉	hyangx
宕開三上陽清	chiangx
宕開三上陽知	triangx
宕開三上陽常	zjangx
宕合三上陽羣	gyangx
宕合三上陽見	kyangx
宕合三上陽並	byangx
宕開三上陽初	chriangx
宕開一上唐定	dangx
宕開一上唐心	sangx
宕合一上唐見	kuangx
宕開一上唐幫	pangx
宕開一上唐精	cangx
宕開一上唐泥	nangx
宕開一上唐匣	ghangx
宕開一上唐透	thangx
宕開一上唐明	mangx
宕開一上唐端	tangx
宕開一上唐來	langx
宕開一上唐影	qangx
宕開一上唐溪	khangx
宕合一上唐影	quangx
宕合一上唐匣	ghuangx
宕開一上唐滂	phangx
宕合一上唐曉	huangx
宕開一上唐見	kangx
宕開一上唐疑	ngangx
宕開一上唐從	zangx
宕開一上唐清	changx
宕開一上唐曉	hangx
宕合一上唐溪	khuangx
梗開二上庚見	krangx
梗開三上庚幫	piengx
梗開三上庚見	kiengx
梗開三上庚影	qiengx
梗開三上庚生	sriengx
梗合三上庚云	yengx
梗合三上庚曉	hyengx
梗開三上庚明	miengx
梗合三上庚見	kyengx
梗開二上庚匣	ghrangx
梗開二上庚明	mrangx
梗合二上庚見	kruangx
梗開二上庚幫	prangx
梗開二上庚知	trangx
梗開二上庚澄	drangx
梗合二上庚影	qruangx
梗開二上庚端	t'rangx
梗開二上庚來	lrangx
梗合二上庚匣	ghruangx
梗開二上庚並	brangx
梗合二上庚溪	khruangx
梗開二上庚孃	nrangx
梗開二上耕見	krengx
梗開二上耕明	mrengx
梗開二上耕匣	ghrengx
梗開二上耕並	brengx
梗開二上耕滂	phrengx
梗開三上清從	ziengx
梗開三上清章	cjengx
梗開三上清徹	thriengx
梗開三上清以	jengx
梗開三上清羣	gjengx
梗合三上清以	jyengx
梗開三上清來	liengx
梗開三上清見	kjengx
梗開三上清幫	pjengx
梗合三上清溪	khjyengx
梗開三上清精	ciengx
梗開三上清影	qjengx
梗開三上清清	chiengx
梗開三上清心	siengx
梗開三上清明	mjengx
梗開三上清澄	driengx
梗合四上青匣	ghuengx
梗合四上青見	kuengx
梗開四上青明	mengx
梗開四上青端	tengx
梗開四上青定	dengx
梗開四上青透	thengx
梗開四上青從	zengx
梗合四上青影	quengx
梗開四上青溪	khengx
梗開四上青泥	nengx
梗開四上青匣	ghengx
梗開四上青心	sengx
梗開四上青幫	pengx
梗合四上青溪	khuengx
梗開四上青見	kengx
梗開四上青滂	phengx
梗開四上青影	qengx
梗開四上青來	lengx
梗開四上青並	bengx
梗合四上青曉	huengx
梗開四上青疑	ngengx
曾開三上蒸章	cjingx
曾開三上蒸徹	thringx
曾開三上蒸羣	gingx
曾開三上蒸生	sringx
曾開一上登端	tongx
曾開一上登滂	phongx
曾開一上登溪	khongx
曾開一上登泥	nongx
流開三上尤云	iux
流開三上尤來	liux
流開三上尤孃	nriux
流開三上尤徹	thriux
流開三上尤知	triux
流開三上尤曉	hiux
流開三上尤見	kiux
流開三上尤書	sjux
流開三上尤昌	chjux
流開三上尤從	ziux
流開三上尤並	biux
流開三上尤幫	piux
流開三上尤溪	khiux
流開三上尤日	njux
流開三上尤羣	giux
流開三上尤澄	driux
流開三上尤以	jux
流開三上尤常	zjux
流開三上尤心	siux
流開三上尤影	qiux
流開三上尤精	ciux
流開三上尤生	sriux
流開三上尤章	cjux
流開三上尤滂	phiux
流開三上尤莊	criux
流開三上尤崇	zriux
流開三上尤初	chriux
流開三上尤滂	phiux
流開一上侯匣	ghux
流開一上侯明	mux
流開一上侯並	bux
流開一上侯端	tux
流開一上侯透	thux
流開一上侯見	kux
流開一上侯疑	ngux
流開一上侯幫	pux
流開一上侯泥	nux
流開一上侯心	sux
流開一上侯曉	hux
流開一上侯滂	phux
流開一上侯影	qux
流開一上侯來	lux
流開一上侯精	cux
流開一上侯溪	khux
流開一上侯定	dux
流開一上侯崇	zr'ux
流開一上侯清	chux
流開三上幽影	qyx
流開三上幽見	kyx
流開三上幽羣	gyx
深開三上侵清	chimx
深開三上侵澄	drimx
深開三上侵溪A	khjimx
深開三上侵來	limx
深開三上侵心	simx
深開三上侵徹	thrimx
深開三上侵精	cimx
深開三上侵日	njimx
深開三上侵章	cjimx
深開三上侵書	sjimx
深開三上侵船	zsjimx
深開三上侵常	zjimx
深開三上侵昌	chjimx
深開三上侵初	chrimx
深開三上侵孃	nrimx
深開三上侵羣B	gimx
深開三上侵見B	kimx
深開三上侵從	zimx
深開三上侵疑B	ngimx
深開三上侵生	srimx
深開三上侵幫B	pimx
深開三上侵影B	qimx
深開三上侵滂B	phimx
深開三上侵溪B	khimx
深開三上侵曉B	himx
深開三上侵知	trimx
深開三上侵以	jimx
深開三上侵崇	zrimx
咸開一上覃見	komx
咸開一上覃定	domx
咸開一上覃影	qomx
咸開一上覃泥	nomx
咸開一上覃透	thomx
咸開一上覃從	zomx
咸開一上覃清	chomx
咸開一上覃疑	ngomx
咸開一上覃精	comx
咸開一上覃心	somx
咸開一上覃溪	khomx
咸開一上覃匣	ghomx
咸開一上覃來	lomx
咸開一上覃端	tomx
咸開一上覃曉	homx
咸開一上談見	kamx
咸開一上談書	sj'amx
咸開一上談來	lamx
咸開一上談透	thamx
咸開一上談端	tamx
咸開一上談定	damx
咸開一上談清	chamx
咸開一上談明	mamx
咸開一上談精	camx
咸開一上談從	zamx
咸開一上談曉	hamx
咸開一上談影	qamx
咸開一上談溪	khamx
咸開三上鹽以	jemx
咸開三上鹽來	liemx
咸開三上鹽曉B	hiemx
咸開三上鹽幫B	piemx
咸開三上鹽章	cjemx
咸開三上鹽溪B	khiemx
咸開三上鹽疑B	ngiemx
咸開三上鹽羣B	giemx
咸開三上鹽見B	kiemx
咸開三上鹽影A	qjemx
咸開三上鹽日	njemx
咸開三上鹽書	sjemx
咸開三上鹽徹	thriemx
咸開三上鹽影B	qiemx
咸開三上鹽從	ziemx
咸開三上鹽清	chiemx
咸開三上鹽精	ciemx
咸開三上鹽溪A	khjemx
咸開三上鹽常	zjemx
咸開四上添透	themx
咸開四上添泥	nemx
咸開四上添端	temx
咸開四上添定	demx
咸開四上添溪	khemx
咸開四上添來	lemx
咸開四上添匣	ghemx
咸開四上添清	chemx
咸開四上添見	kemx
咸開四上添明	memx
咸開三上嚴疑	ngiamx
咸開三上嚴溪	khiamx
咸開三上嚴影	qiamx
咸開二上咸匣	ghremx
咸開二上咸澄	dremx
咸開二上咸溪	khremx
咸開二上咸見	kremx
咸開二上咸崇	zremx
咸開二上咸來	lremx
咸開二上咸莊	cremx
咸開二上咸初	chremx
咸開二上咸曉	hremx
咸開二上咸生	sremx
咸開二上咸影	qremx
咸開二上咸曉	hremx
咸開二上咸孃	nremx
咸開二上咸徹	thremx
咸開二上銜匣	ghramx
咸開二上銜溪	khramx
咸開二上銜生	sramx
咸開二上銜影	qramx
咸開二上銜初	chramx
咸開二上銜曉	hramx
咸開二上銜崇	zramx
咸合三上凡並	byamx
咸合三上凡明	myamx
咸合三上凡幫	pyamx
咸合三上凡溪	khyamx
咸合三上凡滂	phyamx
咸合三上凡徹	thryamx
通開一去東心	sungh
通開三去東並	biungh
通開一去東見	kungh
通開一去東來	lungh
通開一去東端	tungh
通開一去東溪	khungh
通開一去東精	cungh
通開一去東影	qungh
通開一去東清	chungh
通開一去東定	dungh
通開一去東透	thungh
通開三去東澄	driungh
通開三去東幫	piungh
通開三去東溪	khiungh
通開三去東明	miungh
通開三去東曉	hiungh
通開一去東明	mungh
通開三去東清	chiungh
通開三去東滂	phiungh
通開一去東從	zungh
通開三去東知	triungh
通開一去東匣	ghungh
通開一去東泥	nungh
通開三去東章	cjungh
通開三去東昌	chjungh
通開三去東崇	zriungh
通開一去東曉	hungh
通開一去冬心	suungh
通開一去冬精	cuungh
通開一去冬透	thuungh
通開一去冬明	muungh
通開一去冬匣	ghuungh
通開三去鍾以	jyungh
通開三去鍾邪	zsyungh
通開三去鍾並	byungh
通開三去鍾羣	gyungh
通開三去鍾幫	pyungh
通開三去鍾見	kyungh
通開三去鍾影	qyungh
通開三去鍾知	tryungh
通開三去鍾精	cyungh
通開三去鍾徹	thryungh
通開三去鍾日	njyungh
通開三去鍾章	cjyungh
通開三去鍾澄	dryungh
通開三去鍾來	lyungh
通開三去鍾溪	khyungh
通開三去鍾從	zyungh
通開三去鍾孃	nryungh
江開二去江見	krungh
江開二去江匣	ghrungh
江開二去江知	trungh
江開二去江澄	drungh
江開二去江徹	thrungh
江開二去江崇	zrungh
江開二去江滂	phrungh
江開二去江初	chrungh
江開二去江生	srungh
止開三去支章	cjeh
止開三去支並A	bjeh
止合三去支章	cjyeh
止開三去支來	lieh
止開三去支常	zjeh
止開三去支精	cieh
止開三去支心	sieh
止合三去支云	yeh
止合三去支見B	kyeh
止開三去支滂B	phieh
止開三去支幫B	pieh
止開三去支並B	bieh
止合三去支來	lyeh
止開三去支見B	kieh
止開三去支幫A	pjeh
止開三去支羣B	gieh
止開三去支清	chieh
止開三去支以	jeh
止開三去支疑B	ngieh
止開三去支滂A	phjeh
止開三去支從	zieh
止開三去支知	trieh
止開三去支影B	qieh
止合三去支澄	dryeh
止合三去支昌	chjyeh
止開三去支曉B	hieh
止開三去支溪A	khjeh
止開三去支影A	qjeh
止開三去支書	sjeh
止開三去支生	srieh
止合三去支溪A	khjyeh
止合三去支影B	qyeh
止合三去支疑B	ngyeh
止合三去支曉B	hyeh
止合三去支影A	qjyeh
止合三去支常	zjyeh
止開三去支見A	kjeh
止合三去支日	njyeh
止開三去支昌	chjeh
止合三去支心	syeh
止合三去支知	tryeh
止合三去支以	jyeh
止合三去支孃	nryeh
止合三去支見A	kjyeh
止開三去支莊	crieh
止合三去支曉A	hjyeh
止開三去支溪B	khieh
止開三去脂章	cjiih
止合三去脂云	yih
止開三去脂明B	miih
止合三去脂邪	zsyih
止合三去脂精	cyih
止合三去脂心	syih
止合三去脂來	lyih
止開三去脂幫B	piih
止合三去脂羣B	gyih
止開三去脂滂B	phiih
止開三去脂並B	biih
止合三去脂見B	kyih
止合三去脂生	sryih
止合三去脂溪B	khyih
止合三去脂曉B	hyih
止開三去脂常	zjiih
止開三去脂來	liih
止開三去脂孃	nriih
止開三去脂滂A	phjiih
止開三去脂疑B	ngiih
止開三去脂知	triih
止開三去脂溪A	khjiih
止開三去脂澄	driih
止開三去脂明A	mjiih
止開三去脂徹	thriih
止開三去脂見B	kiih
止開三去脂羣B	giih
止合三去脂羣A	gjyih
止合三去脂清	chyih
止開三去脂日	njiih
止開三去脂精	ciih
止開三去脂清	chiih
止開三去脂影B	qiih
止開三去脂心	siih
止開三去脂溪B	khiih
止合三去脂見A	kjyih
止開三去脂並A	bjiih
止合三去脂曉A	hjyih
止開三去脂幫A	pjiih
止合三去脂從	zyih
止開三去脂定	diih
止開三去脂曉B	hiih
止開三去脂以	jiih
止開三去脂船	zsjiih
止開三去脂從	ziih
止合三去脂澄	dryih
止合三去脂昌	chjyih
止合三去脂以	jyih
止合三去脂曉A	hjyih
止合三去脂知	tryih
止開三去脂昌	chjiih
止開三去脂書	sjiih
止合三去脂初	chryih
止合三去脂書	sjyih
止開三去之章	cjih
止開三去之澄	drih
止開三去之邪	zsih
止開三去之清	chih
止開三去之心	sih
止開三去之書	sjih
止開三去之莊	crih
止開三去之來	lih
止開三去之從	zih
止開三去之徹	thrih
止開三去之日	njih
止開三去之生	srih
止開三去之初	chrih
止開三去之以	jih
止開三去之知	trih
止開三去之常	zjih
止開三去之崇	zrih
止開三去之羣	gih
止開三去之昌	chjih
止開三去之影	qih
止開三去之見	kih
止開三去之曉	hih
止開三去之疑	ngih
止開三去之溪	khih
止合三去微明	myoih
止合三去微見	kyoih
止合三去微云	yoih
止合三去微疑	ngyoih
止合三去微幫	pyoih
止合三去微滂	phyoih
止合三去微溪	khyoih
止合三去微影	qyoih
止合三去微曉	hyoih
止合三去微並	byoih
止開三去微見	kioih
止開三去微疑	ngioih
止開三去微溪	khioih
止開三去微曉	hioih
止開三去微羣	gioih
止開三去微影	qioih
遇開三去魚疑	ngioh
遇開三去魚來	lioh
遇開三去魚見	kioh
遇開三去魚清	chioh
遇開三去魚溪	khioh
遇開三去魚常	zjoh
遇開三去魚書	sjoh
遇開三去魚知	trioh
遇開三去魚章	cjoh
遇開三去魚生	srioh
遇開三去魚影	qioh
遇開三去魚澄	drioh
遇開三去魚羣	gioh
遇開三去魚心	sioh
遇開三去魚崇	zrioh
遇開三去魚精	cioh
遇開三去魚莊	crioh
遇開三去魚日	njoh
遇開三去魚以	joh
遇開三去魚曉	hioh
遇開三去魚孃	nrioh
遇開三去魚初	chrioh
遇開三去魚昌	chjoh
遇開三去魚徹	thrioh
遇開三去魚邪	zsioh
遇合三去虞疑	ngyoh
遇合三去虞影	qyoh
遇合三去虞常	zjyoh
遇合三去虞澄	dryoh
遇合三去虞並	byoh
遇合三去虞章	cjyoh
遇合三去虞見	kyoh
遇合三去虞曉	hyoh
遇合三去虞書	sjyoh
遇合三去虞以	jyoh
遇合三去虞日	njyoh
遇合三去虞滂	phyoh
遇合三去虞明	myoh
遇合三去虞精	cyoh
遇合三去虞羣	gyoh
遇合三去虞云	yoh
遇合三去虞從	zyoh
遇合三去虞生	sryoh
遇合三去虞幫	pyoh
遇合三去虞清	chyoh
遇合三去虞知	tryoh
遇合三去虞溪	khyoh
遇合三去虞初	chryoh
遇合三去虞徹	thryoh
遇合三去虞心	syoh
遇合三去虞來	lyoh
遇開一去模明	moh
遇開一去模定	doh
遇開一去模來	loh
遇開一去模端	toh
遇開一去模透	thoh
遇開一去模見	koh
遇開一去模疑	ngoh
遇開一去模匣	ghoh
遇開一去模心	soh
遇開一去模從	zoh
遇開一去模泥	noh
遇開一去模幫	poh
遇開一去模影	qoh
遇開一去模滂	phoh
遇開一去模清	choh
遇開一去模溪	khoh
遇開一去模並	boh
遇開一去模曉	hoh
遇開一去模精	coh
蟹開四去齊精	ceh
蟹開四去齊端	teh
蟹開四去齊從	zeh
蟹開四去齊透	theh
蟹開四去齊定	deh
蟹開四去齊清	cheh
蟹開四去齊心	seh
蟹開四去齊疑	ngeh
蟹開四去齊見	keh
蟹開四去齊匣	gheh
蟹開四去齊溪	kheh
蟹開四去齊影	qeh
蟹開四去齊明	meh
蟹開四去齊幫	peh
蟹合四去齊匣	ghueh
蟹合四去齊見	kueh
蟹合四去齊曉	hueh
蟹開四去齊滂	pheh
蟹開四去齊並	beh
蟹開四去齊來	leh
蟹開四去齊徹	thr'eh
蟹開四去齊泥	neh
蟹開四去齊曉	heh
蟹開三去祭精	cied
蟹合三去祭心	syed
蟹合三去祭云	yed
蟹合三去祭日	njyed
蟹合三去祭章	cjyed
蟹合三去祭生	sryed
蟹合三去祭清	chyed
蟹合三去祭以	jyed
蟹合三去祭知	tryed
蟹合三去祭書	sjyed
蟹開三去祭並A	bjed
蟹合三去祭初	chryed
蟹合三去祭邪	zsyed
蟹開三去祭幫A	pjed
蟹合三去祭見B	kyed
蟹開三去祭明A	mjed
蟹開三去祭生	sried
蟹開三去祭昌	chjed
蟹開三去祭章	cjed
蟹開三去祭常	zjed
蟹開三去祭以	jed
蟹開三去祭影B	qied
蟹開三去祭疑A	ngjed
蟹開三去祭澄	dried
蟹開三去祭來	lied
蟹開三去祭溪B	khied
蟹開三去祭書	sjed
蟹開三去祭見B	kied
蟹開三去祭知	tried
蟹開三去祭羣B	gied
蟹合三去祭常	zjyed
蟹開三去祭徹	thried
蟹合三去祭澄	dryed
蟹開三去祭疑B	ngied
蟹合三去祭精	cyed
蟹開三去祭滂A	phjed
蟹合三去廢溪	khyad
蟹合三去廢曉	hyad
蟹開一去泰透	thad
蟹開一去泰見	kad
蟹開一去泰疑	ngad
蟹開一去泰影	qad
蟹開一去泰泥	nad
蟹開一去泰定	dad
蟹開一去泰匣	ghad
蟹開一去泰端	tad
蟹開一去泰幫	pad
蟹開一去泰滂	phad
蟹合一去泰匣	ghuad
蟹合一去泰定	duad
蟹合一去泰見	kuad
蟹合一去泰精	cuad
蟹合一去泰曉	huad
蟹合一去泰溪	khuad
蟹合一去泰來	luad
蟹合一去泰疑	nguad
蟹合一去泰端	tuad
蟹合一去泰影	quad
蟹合一去泰從	zuad
蟹合一去泰心	suad
蟹合一去泰清	chuad
蟹開一去泰並	bad
蟹開一去泰溪	khad
蟹開一去泰清	chad
蟹開一去泰來	lad
蟹開一去泰曉	had
蟹合一去泰透	thuad
蟹開一去泰明	mad
蟹合一去泰清	chuad
蟹合二去佳見	krueh
蟹開二去佳見	kreh
蟹開二去佳影	qreh
蟹開二去佳匣	ghreh
蟹開二去佳明	mreh
蟹合二去佳匣	ghrueh
蟹開二去佳初	chreh
蟹開二去佳疑	ngreh
蟹開二去佳曉	hreh
蟹開二去佳幫	preh
蟹開二去佳並	breh
蟹開二去佳崇	zreh
蟹開二去佳滂	phreh
蟹開二去佳莊	creh
蟹開二去佳溪	khreh
蟹開二去佳生	sreh
蟹合二去佳曉	hrueh
蟹開二去佳幫	preh
蟹合二去佳知	trueh
蟹合二去皆見	kruaih
蟹開二去皆影	qraih
蟹開二去皆莊	craih
蟹開二去皆見	kraih
蟹開二去皆孃	nraih
蟹開二去皆曉	hraih
蟹開二去皆匣	ghraih
蟹開二去皆疑	ngraih
蟹合二去皆溪	khruaih
蟹開二去皆幫	praih
蟹開二去皆滂	phraih
蟹合二去皆匣	ghruaih
蟹合二去皆疑	ngruaih
蟹開二去皆並	braih
蟹開二去皆明	mraih
蟹合二去皆曉	hruaih
蟹開二去皆生	sraih
蟹開二去皆溪	khraih
蟹合二去皆徹	thruaih
蟹合二去夬見	kruad
蟹合二去夬溪	khruad
蟹開二去夬明	mrad
蟹合二去夬匣	ghruad
蟹開二去夬並	brad
蟹合二去夬影	qruad
蟹合二去夬初	chruad
蟹開二去夬見	krad
蟹開二去夬徹	thrad
蟹開二去夬影	qrad
蟹開二去夬生	srad
蟹開二去夬澄	drad
蟹開二去夬曉	hrad
蟹合二去夬曉	hruad
蟹開二去夬幫	prad
蟹合二去夬清	ch'ruad
蟹開二去夬崇	zrad
蟹開二去夬匣	ghrad
蟹合一去灰定	duaih
蟹合一去灰並	buaih
蟹合一去灰明	muaih
蟹合一去灰滂	phuaih
蟹合一去灰曉	huaih
蟹合一去灰端	tuaih
蟹合一去灰清	chuaih
蟹合一去灰精	cuaih
蟹合一去灰影	quaih
蟹合一去灰透	thuaih
蟹合一去灰見	kuaih
蟹合一去灰匣	ghuaih
蟹合一去灰溪	khuaih
蟹合一去灰心	suaih
蟹合一去灰泥	nuaih
蟹合一去灰來	luaih
蟹合一去灰幫	puaih
蟹合一去灰疑	nguaih
蟹合一去灰匣	ghuaih
蟹開一去咍定	daih
蟹開一去咍精	caih
蟹開一去咍明	maih
蟹開一去咍心	saih
蟹開一去咍透	thaih
蟹開一去咍見	kaih
蟹開一去咍溪	khaih
蟹開一去咍疑	ngaih
蟹開一去咍影	qaih
蟹開一去咍匣	ghaih
蟹開一去咍泥	naih
蟹開一去咍端	taih
蟹開一去咍來	laih
蟹開一去咍清	chaih
蟹開一去咍從	zaih
蟹開一去咍曉	haih
蟹合三去廢幫	pyad
蟹合三去廢滂	phyad
蟹合三去廢影	qyad
蟹合三去廢並	byad
蟹合三去廢曉	hyad
蟹合三去廢羣	gyad
蟹開三去廢疑	ngiad
臻開三去眞章	cjinh
臻開三去眞心	sinh
臻開三去眞日	njinh
臻開三去眞以	jinh
臻開三去眞來	linh
臻開三去眞幫A	pjinh
臻開三去眞澄	drinh
臻開三去眞常	zjinh
臻開三去眞書	sjinh
臻開三去眞溪B	khinh
臻開三去眞邪	zsinh
臻開三去眞疑B	nginh
臻開三去眞精	cinh
臻開三去眞曉B	hinh
臻開三去眞知	trinh
臻開三去眞羣B	ginh
臻開三去臻初	chrinh
臻開三去眞影A	qjinh
臻開三去眞徹	thrinh
臻開三去眞滂A	phjinh
臻開三去眞清	chinh
臻開三去眞溪A	khjinh
臻合三去諄見	kjynh
臻合三去諄章	cjynh
臻合三去諄心	synh
臻合三去諄邪	zsynh
臻合三去諄精	cynh
臻合三去諄書	sjynh
臻合三去諄日	njynh
臻合三去諄船	zsjynh
臻合三去文明	myonh
臻合三去文云	yonh
臻合三去文曉	hyonh
臻合三去文滂	phyonh
臻合三去文幫	pyonh
臻合三去文影	qyonh
臻合三去文見	kyonh
臻合三去文羣	gyonh
臻合三去文並	byonh
臻開三去欣曉	hionh
臻開三去欣見	kionh
臻開三去欣羣	gionh
臻開三去欣影	qionh
臻開三去欣疑	ngionh
臻合三去元疑	ngyanh
臻合三去元影	qyanh
臻合三去元幫	pyanh
臻合三去元溪	khyanh
臻合三去元明	myanh
臻合三去元並	byanh
臻合三去元滂	phyanh
臻開三去元見	kianh
臻開三去元影	qianh
臻開三去元曉	hianh
臻合三去元曉	hyanh
臻開三去元羣	gianh
臻合三去元滂	phyanh
臻合三去元云	yanh
臻開三去元疑	ngianh
臻合三去元羣	gyanh
臻合三去元見	kyanh
臻合一去魂匣	ghuonh
臻合一去魂端	tuonh
臻合一去魂心	suonh
臻合一去魂溪	khuonh
臻合一去魂泥	nuonh
臻合一去魂影	quonh
臻合一去魂明	muonh
臻合一去魂從	zuonh
臻合一去魂見	kuonh
臻合一去魂滂	phuonh
臻合一去魂定	duonh
臻合一去魂清	chuonh
臻合一去魂並	buonh
臻合一去魂疑	nguonh
臻合一去魂來	luonh
臻合一去魂幫	puonh
臻合一去魂曉	huonh
臻合一去魂精	cuonh
臻開一去痕匣	ghonh
臻開一去痕見	konh
臻開一去痕疑	ngonh
臻開一去痕影	qonh
山開一去寒匣	ghanh
山開一去寒透	thanh
山開一去寒影	qanh
山開一去寒端	tanh
山開一去寒定	danh
山開一去寒見	kanh
山開一去寒疑	nganh
山開一去寒溪	khanh
山開一去寒曉	hanh
山開一去寒來	lanh
山開一去寒泥	nanh
山開一去寒清	chanh
山開一去寒心	sanh
山開一去寒精	canh
山開一去寒從	zanh
山合一去桓匣	ghuanh
山合一去桓精	cuanh
山合一去桓影	quanh
山合一去桓見	kuanh
山合一去桓清	chuanh
山合一去桓疑	nguanh
山合一去桓定	duanh
山合一去桓來	luanh
山合一去桓端	tuanh
山合一去桓透	thuanh
山合一去桓曉	huanh
山合一去桓心	suanh
山合一去桓明	muanh
山合一去桓幫	puanh
山合一去桓滂	phuanh
山合一去桓並	buanh
山合一去桓泥	nuanh
山合一去桓從	zuanh
山合一去桓溪	khuanh
山開二去刪見	kranh
山開二去刪疑	ngranh
山開二去刪影	qranh
山開二去刪生	sranh
山開二去刪匣	ghranh
山開二去刪明	mranh
山合二去刪影	qruanh
山合二去刪匣	ghruanh
山合二去刪見	kruanh
山合二去刪生	sruanh
山合二去刪初	chruanh
山合二去刪疑	ngruanh
山開二去刪崇	zranh
山開二去刪滂	phranh
山合二去刪孃	nruanh
山開二去刪初	chranh
山開二去刪徹	thranh
山開二去山見	krenh
山開二去山匣	ghrenh
山開二去山並	brenh
山開二去山滂	phrenh
山合二去山匣	ghruenh
山開二去山明	mrenh
山開二去山澄	drenh
山開二去山幫	prenh
山合二去山見	kruenh
山開四去先心	senh
山開四去先清	chenh
山合四去先曉	huenh
山合四去先匣	ghuenh
山合四去先見	kuenh
山開四去先定	denh
山開四去先透	thenh
山開四去先來	lenh
山開四去先見	kenh
山開四去先泥	nenh
山開四去先溪	khenh
山開四去先匣	ghenh
山開四去先疑	ngenh
山開四去先影	qenh
山開四去先精	cenh
山開四去先明	menh
山開四去先滂	phenh
山開四去先從	zenh
山合四去先影	quenh
山開四去先端	tenh
山開四去先曉	henh
山開三去仙心	sienh
山開三去仙章	cjenh
山開三去仙常	zjenh
山開三去仙疑B	ngienh
山開三去仙溪A	khjenh
山合三去仙見A	kjyenh
山合三去仙云	yenh
山開三去仙明A	mjenh
山合三去仙昌	chjyenh
山合三去仙以	jyenh
山開三去仙知	trienh
山合三去仙日	njyenh
山開三去仙精	cienh
山開三去仙昌	chjenh
山開三去仙書	sjenh
山開三去仙影A	qjenh
山合三去仙見B	kyenh
山合三去仙羣B	gyenh
山合三去仙來	lyenh
山合三去仙徹	thryenh
山開三去仙幫B	pienh
山合三去仙生	sryenh
山合三去仙清	chyenh
山開三去仙並B	bienh
山合三去仙邪	zsyenh
山合三去仙心	syenh
山合三去仙崇	zryenh
山合三去仙莊	cryenh
山合三去仙澄	dryenh
山開三去仙從	zienh
山開三去仙邪	zsienh
山開三去仙滂A	phjenh
山合三去仙常	zjyenh
山開三去仙孃	nrienh
山合三去仙知	tryenh
山開三去仙以	jenh
山開三去仙並A	bjenh
山開三去仙澄	drienh
山開三去仙來	lienh
山合三去仙溪B	khyenh
山合三去仙章	cjyenh
山開四去先幫	penh
效開四去蕭心	seuh
效開四去蕭透	theuh
效開四去蕭端	teuh
效開四去蕭見	keuh
效開四去蕭泥	neuh
效開四去蕭定	deuh
效開四去蕭溪	kheuh
效開四去蕭來	leuh
效開四去蕭疑	ngeuh
效開四去蕭影	qeuh
效開四去蕭曉	heuh
效開三去宵心	sieuh
效開三去宵章	cjeuh
效開三去宵以	jeuh
效開三去宵影A	qjeuh
效開三去宵澄	drieuh
效開三去宵常	zjeuh
效開三去宵羣B	gieuh
效開三去宵滂A	phjeuh
效開三去宵從	zieuh
效開三去宵明A	mjeuh
效開三去宵清	chieuh
效開三去宵來	lieuh
效開三去宵溪B	khieuh
效開三去宵疑B	ngieuh
效開三去宵精	cieuh
效開三去宵明B	mieuh
效開三去宵並A	bjeuh
效開三去宵書	sjeuh
效開三去宵徹	thrieuh
效開三去宵幫B	pieuh
效開三去宵羣A	gjeuh
效開三去宵日	njeuh
效開二去肴匣	ghrauh
效開二去肴見	krauh
效開二去肴曉	hrauh
效開二去肴知	trauh
效開二去肴幫	prauh
效開二去肴溪	khrauh
效開二去肴明	mrauh
效開二去肴滂	phrauh
效開二去肴徹	thrauh
效開二去肴生	srauh
效開二去肴澄	drauh
效開二去肴孃	nrauh
效開二去肴莊	crauh
效開二去肴並	brauh
效開二去肴初	chrauh
效開二去肴影	qrauh
效開二去肴疑	ngrauh
效開二去肴崇	zrauh
效開一去豪匣	ghauh
效開一去豪定	dauh
效開一去豪端	tauh
效開一去豪見	kauh
效開一去豪疑	ngauh
效開一去豪明	mauh
效開一去豪來	lauh
效開一去豪清	chauh
效開一去豪並	bauh
效開一去豪幫	pauh
效開一去豪從	zauh
效開一去豪影	qauh
效開一去豪心	sauh
效開一去豪溪	khauh
效開一去豪精	cauh
效開一去豪曉	hauh
效開一去豪泥	nauh
果開一去歌見	kah
果開一去歌匣	ghah
果開一去歌精	cah
果開一去歌端	tah
果開一去歌來	lah
果開一去歌溪	khah
果開一去歌疑	ngah
果開一去歌定	dah
果開一去歌泥	nah
果開一去歌心	sah
果開一去歌曉	hah
果開一去歌透	thah
果合一去戈見	kuah
果合一去戈匣	ghuah
果合一去戈精	cuah
果合一去戈溪	khuah
果合一去戈透	thuah
果合一去戈幫	puah
果合一去戈清	chuah
果合一去戈明	muah
果合一去戈泥	nuah
果合一去戈滂	phuah
果合一去戈從	zuah
果合一去戈疑	nguah
果合一去戈清	chuah
果合一去戈曉	huah
果合一去戈定	duah
果合一去戈並	buah
果合一去戈來	luah
果合一去戈端	tuah
果合一去戈清	chuah
果合一去戈心	suah
果開一去歌影	qah
果合一去戈影	quah
假開二去麻明	mrah
假開二去麻見	krah
假開二去麻影	qrah
假開二去麻曉	hrah
假開二去麻疑	ngrah
假開二去麻徹	thrah
假開二去麻知	trah
假開二去麻莊	crah
假開二去麻崇	zrah
假開三去麻邪	zsiah
假開二去麻溪	khrah
假開二去麻匣	ghrah
假開三去麻從	ziah
假開三去麻以	jah
假開三去麻昌	chjah
假開三去麻心	siah
假開三去麻章	cjah
假開三去麻精	ciah
假開三去麻書	sjah
假開三去麻船	zsjah
假開二去麻幫	prah
假開二去麻滂	phrah
假合二去麻匣	ghruah
假合二去麻曉	hruah
假合二去麻溪	khruah
假合二去麻生	sruah
假開二去麻並	brah
假開二去麻泥	n'rah
假開三去麻清	chiah
假開二去麻生	srah
假合二去麻見	kruah
假開二去麻澄	drah
假合二去麻疑	ngruah
假合二去麻影	qruah
宕開三去陽以	jangh
宕開三去陽來	liangh
宕開三去陽崇	zriangh
宕開三去陽日	njangh
宕開三去陽書	sjangh
宕開三去陽知	triangh
宕開三去陽徹	thriangh
宕開三去陽曉	hiangh
宕開三去陽澄	driangh
宕開三去陽孃	nriangh
宕開三去陽從	ziangh
宕開三去陽章	cjangh
宕開三去陽常	zjangh
宕開三去陽莊	criangh
宕開三去陽影	qiangh
宕開三去陽羣	giangh
宕開三去陽昌	chjangh
宕開三去陽初	chriangh
宕開三去陽精	ciangh
宕開三去陽疑	ngiangh
宕合三去陽滂	phyangh
宕合三去陽明	myangh
宕合三去陽曉	hyangh
宕合三去陽見	kyangh
宕合三去陽云	yangh
宕合三去陽幫	pyangh
宕開三去陽心	siangh
宕開三去陽見	kiangh
宕開三去陽溪	khiangh
宕開三去陽清	chiangh
宕合三去陽羣	gyangh
宕合三去陽並	byangh
宕開一去唐定	dangh
宕開一去唐來	langh
宕開一去唐匣	ghangh
宕開一去唐影	qangh
宕開一去唐疑	ngangh
宕開一去唐精	cangh
宕開一去唐並	bangh
宕開一去唐從	zangh
宕開一去唐端	tangh
宕開一去唐溪	khangh
宕開一去唐幫	pangh
宕開一去唐透	thangh
宕合一去唐溪	khuangh
宕開一去唐泥	nangh
宕開一去唐心	sangh
宕合一去唐匣	ghuangh
宕合一去唐見	kuangh
宕開一去唐見	kangh
宕合一去唐曉	huangh
宕開一去唐明	mangh
宕合一去唐影	quangh
梗開三去庚影	qiengh
梗開三去庚見	kiengh
梗開三去庚羣	giengh
梗開三去庚溪	khiengh
梗開二去庚見	krangh
梗開三去庚明	miengh
梗開三去庚並	biengh
梗開二去庚明	mrangh
梗合二去庚匣	ghruangh
梗開三去庚幫	piengh
梗合三去庚云	yengh
梗開二去庚匣	ghrangh
梗開二去庚影	qrangh
梗開二去庚初	chrangh
梗開二去庚知	trangh
梗開二去庚徹	thrangh
梗開二去庚幫	prangh
梗開二去庚澄	drangh
梗開二去庚生	srangh
梗開三去庚疑	ngiengh
梗開二去庚並	brangh
梗開二去庚曉	hrangh
梗合二去庚影	qruangh
梗開二去耕莊	crengh
梗開二去耕幫	prengh
梗開二去耕並	brengh
梗開二去耕影	qrengh
梗開二去耕疑	ngrengh
梗合二去耕曉	hruengh
梗開三去清見	kjengh
梗開三去清清	chiengh
梗開三去清章	cjengh
梗開三去清書	sjengh
梗開三去清澄	driengh
梗開三去清徹	thriengh
梗開三去清心	siengh
梗開三去清來	liengh
梗開三去清滂	phjengh
梗合三去清曉	hjyengh
梗開三去清幫	pjengh
梗開三去清並	bjengh
梗開三去清從	ziengh
梗開三去清常	zjengh
梗開三去清明	mjengh
梗開三去清溪	khjengh
梗開三去清曉	hjengh
梗開三去清精	ciengh
梗開四去青見	kengh
梗開四去青泥	nengh
梗開四去青心	sengh
梗開四去青匣	ghengh
梗開四去青定	dengh
梗開四去青端	tengh
梗開四去青溪	khengh
梗開四去青透	thengh
梗開四去青清	chengh
梗開四去青明	mengh
梗開四去青影	qengh
梗開四去青來	lengh
曾開三去蒸章	cjingh
曾開三去蒸以	jingh
曾開三去蒸船	zsjingh
曾開三去蒸日	njingh
曾開三去蒸影	qingh
曾開三去蒸精	cingh
曾開三去蒸曉	hingh
曾開三去蒸書	sjingh
曾開三去蒸澄	dringh
曾開三去蒸來	lingh
曾開三去蒸並	bingh
曾開三去蒸昌	chjingh
曾開三去蒸疑	ngingh
曾開三去蒸常	zjingh
曾開三去蒸徹	thringh
曾開三去蒸羣	gingh
曾開一去登端	tongh
曾開一去登從	zongh
曾開一去登見	kongh
曾開一去登清	chongh
曾開一去登定	dongh
曾開一去登明	mongh
曾開一去登幫	pongh
曾開一去登並	bongh
曾開一去登來	longh
曾開一去登精	congh
曾開一去登心	songh
曾開一去登透	thongh
流開三去尤云	iuh
流開三去尤見	kiuh
流開三去尤澄	driuh
流開三去尤知	triuh
流開三去尤書	sjuh
流開三去尤昌	chjuh
流開三去尤邪	zsiuh
流開三去尤曉	hiuh
流開三去尤章	cjuh
流開三去尤羣	giuh
流開三去尤生	sriuh
流開三去尤莊	criuh
流開三去尤滂	phiuh
流開三去尤初	chriuh
流開三去尤幫	piuh
流開三去尤徹	thriuh
流開三去尤來	liuh
流開三去尤心	siuh
流開三去尤精	ciuh
流開三去尤崇	zriuh
流開三去尤從	ziuh
流開三去尤孃	nriuh
流開三去尤並	biuh
流開三去尤以	juh
流開三去尤常	zjuh
流開三去尤日	njuh
流開三去尤明	miuh
流開三去尤疑	ngiuh
流開三去尤溪	khiuh
流開三去尤清	chiuh
流開一去侯匣	ghuh
流開一去侯溪	khuh
流開一去侯明	muh
流開一去侯滂	phuh
流開一去侯定	duh
流開一去侯端	tuh
流開一去侯泥	nuh
流開一去侯心	suh
流開一去侯精	cuh
流開一去侯透	thuh
流開一去侯影	quh
流開一去侯見	kuh
流開一去侯清	chuh
流開一去侯來	luh
流開一去侯曉	huh
流開一去侯並	buh
流開一去侯疑	nguh
流開一去侯從	zuh
流開三去幽影	qyh
流開三去幽明	myh
流開三去幽溪	khyh
流開三去幽羣	gyh
深開三去侵清	chimh
深開三去侵精	cimh
深開三去侵日	njimh
深開三去侵澄	drimh
深開三去侵章	cjimh
深開三去侵羣B	gimh
深開三去侵見B	kimh
深開三去侵孃	nrimh
深開三去侵影B	qimh
深開三去侵生	srimh
深開三去侵徹	thrimh
深開三去侵莊	crimh
深開三去侵初	chrimh
深開三去侵疑B	ngimh
深開三去侵知	trimh
深開三去侵來	limh
深開三去侵常	zjimh
深開三去侵云	imh
深開三去侵書	sjimh
咸開一去覃溪	khomh
咸開一去覃見	komh
咸開一去覃匣	ghomh
咸開一去覃影	qomh
咸開一去覃透	thomh
咸開一去覃心	somh
咸開一去覃清	chomh
咸開一去覃定	domh
咸開一去覃疑	ngomh
咸開一去覃端	tomh
咸開一去覃泥	nomh
咸開一去覃來	lomh
咸開一去覃曉	homh
咸開一去覃精	comh
咸開一去談溪	khamh
咸開一去談來	lamh
咸開一去談透	thamh
咸開一去談見	kamh
咸開一去談曉	hamh
咸開一去談匣	ghamh
咸開一去談定	damh
咸開一去談從	zamh
咸開一去談端	tamh
咸開一去談心	samh
咸開三去鹽以	jemh
咸開三去鹽常	zjemh
咸開三去鹽日	njemh
咸開三去鹽影A	qjemh
咸開三去鹽幫B	piemh
咸開三去鹽疑B	ngiemh
咸開三去鹽書	sjemh
咸開三去鹽精	ciemh
咸開三去鹽清	chiemh
咸開三去鹽來	liemh
咸開三去鹽徹	thriemh
咸開三去鹽昌	chjemh
咸開三去鹽影B	qiemh
咸開三去鹽從	ziemh
咸開三去鹽章	cjemh
咸開四去添透	themh
咸開四去添泥	nemh
咸開四去添端	temh
咸開四去添心	semh
咸開四去添定	demh
咸開四去添見	kemh
咸開四去添影	qemh
咸開四去添精	cemh
咸開四去添從	zemh
咸開四去添見	kemh
咸開四去添溪	khemh
咸開四去添來	lemh
咸開三去嚴疑	ngiamh
咸開三去嚴曉	hiamh
咸開三去嚴溪	khiamh
咸合三去凡明	myamh
咸開二去咸匣	ghremh
咸開二去咸影	qremh
咸開二去咸莊	cremh
咸開二去咸知	tremh
咸開二去咸溪	khremh
咸開二去咸澄	dremh
咸開二去咸崇	zremh
咸開二去咸見	kremh
咸開二去咸孃	nremh
咸開二去咸疑	ngremh
咸開二去銜見	kramh
咸開二去銜初	chramh
咸開二去銜莊	cramh
咸開二去銜生	sramh
咸開二去銜曉	hramh
咸開二去銜並	bramh
咸開二去銜匣	ghramh
咸開二去銜崇	zramh
咸開二去銜影	qramh
咸合三去凡並	byamh
咸合三去凡滂	phyamh
咸開三去嚴見	kiamh
咸開三去嚴溪	khiamh
咸開三去嚴影	qiamh
通開一入東影	quk
通開一入東定	duk
通開一入東見	kuk
通開一入東匣	ghuk
通開一入東溪	khuk
通開一入東透	thuk
通開一入東端	tuk
通開一入東心	suk
通開一入東來	luk
通開一入東曉	huk
通開一入東從	zuk
通開一入東清	chuk
通開一入東精	cuk
通開一入東並	buk
通開一入東滂	phuk
通開一入東幫	puk
通開一入東明	muk
通開三入東幫	piuk
通開三入東並	biuk
通開三入東生	sriuk
通開三入東來	liuk
通開三入東澄	driuk
通開三入東見	kiuk
通開三入東溪	khiuk
通開三入東常	zjuk
通開三入東昌	chjuk
通開三入東以	juk
通開三入東羣	giuk
通開三入東清	chiuk
通開三入東日	njuk
通開三入東章	cjuk
通開三入東書	sjuk
通開三入東曉	hiuk
通開三入東知	triuk
通開三入東精	ciuk
通開三入東初	chriuk
通開三入東孃	nriuk
通開三入東莊	criuk
通開三入東滂	phiuk
通開三入東影	qiuk
通開三入東心	siuk
通開三入東明	miuk
通開三入東云	iuk
通開三入東徹	thriuk
通開三入東疑	ngiuk
通開三入東從	ziuk
通開一入冬影	quuk
通開一入冬定	duuk
通開一入冬端	tuuk
通開一入冬溪	khuuk
通開一入冬匣	ghuuk
通開一入冬並	buuk
通開一入冬心	suuk
通開一入冬見	kuuk
通開一入冬明	muuk
通開一入冬曉	huuk
通開一入冬泥	nuuk
通開一入冬精	cuuk
通開一入冬幫	puuk
通開一入冬來	luuk
通開一入冬疑	nguuk
通開三入鍾章	cjyuk
通開三入鍾疑	ngyuk
通開三入鍾曉	hyuk
通開三入鍾見	kyuk
通開三入鍾羣	gyuk
通開三入鍾常	zjyuk
通開三入鍾昌	chjyuk
通開三入鍾日	njyuk
通開三入鍾書	sjyuk
通開三入鍾以	jyuk
通開三入鍾澄	dryuk
通開三入鍾來	lyuk
通開三入鍾溪	khyuk
通開三入鍾知	tryuk
通開三入鍾精	cyuk
通開三入鍾船	zsjyuk
通開三入鍾並	byuk
通開三入鍾清	chyuk
通開三入鍾邪	zsyuk
通開三入鍾心	syuk
通開三入鍾幫	pyuk
通開三入鍾徹	thryuk
江開二入江見	kruk
江開二入江疑	ngruk
江開二入江崇	zruk
江開二入江莊	cruk
江開二入江生	sruk
江開二入江知	truk
江開二入江幫	pruk
江開二入江明	mruk
江開二入江並	bruk
江開二入江滂	phruk
江開二入江溪	khruk
江開二入江澄	druk
江開二入江影	qruk
江開二入江孃	nruk
江開二入江徹	thruk
江開二入江來	lruk
江開二入江匣	ghruk
江開二入江曉	hruk
江開二入江初	chruk
臻開三入眞章	cjit
臻開三入眞日	njit
臻開三入眞船	zsjit
臻開三入眞澄	drit
臻開三入眞心	sit
臻開三入眞影A	qjit
臻開三入眞清	chit
臻開三入眞滂A	phjit
臻開三入眞見A	kjit
臻開三入眞孃	nrit
臻開三入眞以	jit
臻開三入眞溪A	khjit
臻開三入眞曉A	hjit
臻開三入眞徹	thrit
臻開三入眞來	lit
臻開三入眞知	trit
臻開三入眞從	zit
臻開三入臻初	chrit
臻開三入眞書	sjit
臻開三入眞精	cit
臻開三入眞明A	mjit
臻開三入眞幫A	pjit
臻開三入眞羣B	git
臻開三入眞並A	bjit
臻合三入眞云	yt
臻合三入諄生	sryt
臻開三入眞昌	chjit
臻開三入臻崇	zrit
臻開三入眞明B	mit
臻開三入眞並B	bit
臻開三入眞影B	qit
臻開三入眞疑B	ngit
臻開三入眞幫B	pit
臻合三入諄知	tryt
臻開三入眞曉B	hit
臻開三入眞見B	kit
臻開三入眞知	trit
臻合三入諄曉	hjyt
臻合三入諄船	zsjyt
臻合三入諄見	kjyt
臻合三入諄從	zyt
臻合三入諄以	jyt
臻合三入諄精	cyt
臻合三入諄心	syt
臻合三入諄來	lyt
臻合三入諄徹	thryt
臻合三入諄知	tryt
臻合三入諄澄	dryt
臻合三入諄昌	chjyt
臻合三入諄清	chyt
臻合三入諄莊	cryt
臻合三入眞曉B	hyt
臻開三入臻莊	crit
臻開三入臻生	srit
臻開三入臻崇	zrit
臻合三入文明	myot
臻合三入文幫	pyot
臻合三入文影	qyot
臻合三入文見	kyot
臻合三入文溪	khyot
臻合三入文羣	gyot
臻合三入文並	byot
臻合三入文曉	hyot
臻合三入文云	yot
臻合三入文滂	phyot
臻合三入文疑	ngyot
臻開三入欣曉	hiot
臻開三入眞見B	kit
臻開三入欣疑	ngiot
臻開三入欣羣	giot
臻開三入欣溪	khiot
臻合三入元疑	ngyat
臻合三入元並	byat
臻合三入元云	yat
臻合三入元見	kyat
臻合三入元影	qyat
臻合三入元羣	gyat
臻合三入元溪	khyat
臻合三入元幫	pyat
臻合三入元明	myat
臻合三入元曉	hyat
臻開三入元影	qiat
臻開三入元曉	hiat
臻開三入元見	kiat
臻開三入元羣	giat
臻合三入元滂	phyat
臻開三入元疑	ngiat
臻合一入魂明	muot
臻合一入魂透	thuot
臻合一入魂見	kuot
臻合一入魂並	buot
臻合一入魂端	tuot
臻合一入魂透	thuot
臻合一入魂定	duot
臻合一入魂影	quot
臻合一入魂曉	huot
臻合一入魂疑	nguot
臻合一入魂滂	phuot
臻合一入魂來	luot
臻合一入魂溪	khuot
臻合一入魂泥	nuot
臻合一入魂心	suot
臻合一入魂清	chuot
臻合一入魂從	zuot
臻開一入痕匣	ghot
臻合一入魂匣	ghuot
臻合一入魂精	cuot
山開一入寒匣	ghat
山開一入寒曉	hat
山開一入寒端	tat
山開一入寒透	that
山開一入寒影	qat
山開一入寒來	lat
山開一入寒溪	khat
山開一入寒定	dat
山開一入寒從	zat
山開一入寒疑	ngat
山開一入寒見	kat
山開一入寒心	sat
山開一入寒清	chat
山開一入寒泥	nat
山開一入寒明	mat
山合一入桓明	muat
山合一入桓疑	nguat
山合一入桓從	zuat
山合一入桓幫	puat
山開一入寒精	cat
山合一入桓見	kuat
山合一入桓溪	khuat
山合一入桓匣	ghuat
山合一入桓定	duat
山合一入桓曉	huat
山合一入桓影	quat
山合一入桓精	cuat
山合一入桓滂	phuat
山合一入桓透	thuat
山合一入桓來	luat
山合一入桓端	tuat
山合一入桓清	chuat
山合一入桓並	buat
山開二入山匣	ghret
山開二入山莊	cret
山開二入山並	bret
山開二入山溪	khret
山合二入山匣	ghruet
山開二入山幫	pret
山合二入山知	truet
山合二入山影	qruet
山合二入山孃	nruet
山開二入山初	chret
山合二入山見	kruet
山開二入山見	kret
山開二入山影	qret
山開二入山生	sret
山開二入山明	mret
山合二入山曉	hruet
山開二入山孃	nret
山合二入山疑	ngruet
山合二入山溪	khruet
山開二入山滂	phret
山合二入山莊	cruet
山開二入刪匣	ghrat
山開二入刪影	qrat
山開二入刪疑	ngrat
山開二入刪初	chrat
山開二入刪溪	khrat
山開二入刪曉	hrat
山開二入刪徹	thrat
山合二入刪見	kruat
山合二入刪匣	ghruat
山合二入刪徹	thruat
山合二入刪知	truat
山合二入刪生	sruat
山合二入刪疑	ngruat
山合二入刪初	chruat
山開二入刪明	mrat
山合二入刪孃	nruat
山開二入刪幫	prat
山開二入刪見	krat
山開二入刪崇	zrat
山開二入刪知	trat
山開二入刪日	nj'rat
山開四入先心	set
山開四入先清	chet
山開四入先見	ket
山開四入先精	cet
山合四入先曉	huet
山合四入先溪	khuet
山合四入先見	kuet
山合四入先匣	ghuet
山合四入先影	quet
山開四入先定	det
山開四入先透	thet
山開四入先匣	ghet
山開四入先泥	net
山開四入先從	zet
山開四入先疑	nget
山開四入先明	met
山開四入先幫	pet
山開四入先影	qet
山開四入先溪	khet
山開四入先曉	het
山開四入先滂	phet
山開四入先並	bet
山開四入先端	tet
山開四入先來	let
山開三入仙心	siet
山開三入仙來	liet
山開三入仙知	triet
山開三入仙羣B	giet
山開三入仙日	njet
山開三入仙章	cjet
山開三入仙船	zsjet
山開三入仙常	zjet
山開三入仙疑B	ngiet
山開三入仙明A	mjet
山開三入仙溪B	khiet
山開三入仙幫A	pjet
山合三入仙從	zyet
山合三入仙精	cyet
山合三入仙心	syet
山合三入仙徹	thryet
山合三入仙以	jyet
山合三入仙溪A	khjyet
山合三入仙影B	qyet
山合三入仙日	njyet
山合三入仙書	sjyet
山合三入仙章	cjyet
山合三入仙昌	chjyet
山合三入仙知	tryet
山合三入仙來	lyet
山開三入仙滂A	phjet
山開三入仙並B	biet
山開三入仙澄	driet
山開三入仙幫B	piet
山合三入仙生	sryet
山開三入仙見B	kiet
山開三入仙書	sjet
山合三入仙孃	nryet
山合三入仙曉B	hyet
山合三入仙影A	qjyet
山合三入仙見B	kyet
山合三入仙莊	cryet
山合三入仙清	chyet
山開三入仙精	ciet
山開三入仙生	sriet
山開三入仙影B	qiet
山開三入仙徹	thriet
山開三入仙曉B	hiet
山合三入仙昌	chjyet
山開三入仙初	chriet
山合三入仙邪	zsyet
山開三入仙昌	chjet
山開三入仙以	jet
山開三入仙崇	zriet
宕開三入陽以	jak
宕開三入陽來	liak
宕開三入陽見	kiak
宕開三入陽章	cjak
宕開三入陽書	sjak
宕開三入陽日	njak
宕開三入陽昌	chjak
宕開三入陽影	qiak
宕開三入陽溪	khiak
宕開三入陽疑	ngiak
宕開三入陽常	zjak
宕開三入陽徹	thriak
宕開三入陽心	siak
宕開三入陽莊	criak
宕開三入陽精	ciak
宕開三入陽從	ziak
宕開三入陽清	chiak
宕開三入陽羣	giak
宕合三入陽影	qyak
宕合三入陽並	byak
宕合三入陽曉	hyak
宕合三入陽云	yak
宕合三入陽見	kyak
宕開三入陽知	triak
宕開三入陽澄	driak
宕合三入陽溪	khyak
宕合三入陽羣	gyak
宕開三入陽孃	nriak
宕合三入陽滂	phyak
宕開三入陽曉	hiak
宕開一入唐定	dak
宕開一入唐明	mak
宕開一入唐來	lak
宕開一入唐透	thak
宕開一入唐精	cak
宕開一入唐清	chak
宕開一入唐見	kak
宕開一入唐溪	khak
宕開一入唐疑	ngak
宕開一入唐滂	phak
宕開一入唐影	qak
宕開一入唐並	bak
宕開一入唐曉	hak
宕開一入唐心	sak
宕開一入唐匣	ghak
宕開一入唐從	zak
宕開一入唐幫	pak
宕開一入唐泥	nak
宕合一入唐曉	huak
宕合一入唐見	kuak
宕合一入唐影	quak
宕合一入唐匣	ghuak
宕合一入唐溪	khuak
宕合一入唐疑	nguak
宕合一入唐來	luak
宕合一入唐精	cuak
梗開二入庚明	mrak
梗開二入庚知	trak
梗開二入庚並	brak
梗開二入庚幫	prak
梗開三入庚羣	giek
梗開三入庚見	kiek
梗開三入庚生	sriek
梗開三入庚初	chriek
梗合二入庚匣	ghruak
梗開二入庚莊	crak
梗開二入庚崇	zrak
梗開三入庚溪	khiek
梗開二入庚疑	ngrak
梗開三入庚疑	ngiek
梗開二入庚溪	khrak
梗開二入庚影	qrak
梗開三入庚曉	hiek
梗開二入庚徹	thrak
梗合二入庚影	qruak
梗開二入庚滂	phrak
梗開二入庚曉	hrak
梗開二入庚匣	ghrak
梗開二入庚見	krak
梗合二入庚曉	hruak
梗開二入庚澄	drak
梗合二入庚見	kruak
梗合三入庚影	qyek
梗開二入庚孃	nrak
梗合二入庚溪	khruak
梗開三入庚並	biek
梗開二入耕明	mrek
梗合二入耕匣	ghruek
梗合二入耕見	kruek
梗開二入耕幫	prek
梗開二入耕並	brek
梗開二入耕崇	zrek
梗開二入耕莊	crek
梗合二入耕崇	zruek
梗開二入耕初	chrek
梗開二入耕溪	khrek
梗合二入耕曉	hruek
梗開二入耕匣	ghrek
梗開二入耕見	krek
梗開二入耕知	trek
梗開二入耕影	qrek
梗開二入耕生	srek
梗開二入耕滂	phrek
梗開二入耕疑	ngrek
梗開二入耕來	lrek
梗合二入耕莊	cruek
梗合二入耕生	sruek
梗合二入耕羣	gruek
梗開二入耕孃	nrek
梗開三入清心	siek
梗開三入清精	ciek
梗開三入清影	qjek
梗開三入清以	jek
梗開三入清書	sjek
梗開三入清昌	chjek
梗開三入清常	zjek
梗開三入清章	cjek
梗開三入清澄	driek
梗開三入清清	chiek
梗開三入清邪	zsiek
梗開三入清從	ziek
梗開三入清並	bjek
梗合三入清以	jyek
梗合三入清曉	hjyek
梗開三入清幫	pjek
梗開三入清滂	phjek
梗開三入清船	zsjek
梗開三入庚幫	piek
梗開三入清知	triek
梗開三入清徹	thriek
梗合三入清章	cjyek
梗合三入清清	chyek
梗開四入青心	sek
梗開四入青見	kek
梗開四入青滂	phek
梗開四入青來	lek
梗開四入青端	tek
梗開四入青匣	ghek
梗開四入青疑	ngek
梗開四入青定	dek
梗開四入青透	thek
梗開四入青精	cek
梗開四入青溪	khek
梗開四入青泥	nek
梗開四入青從	zek
梗開四入青明	mek
梗開四入青並	bek
梗開四入青幫	pek
梗合四入青溪	khuek
梗合四入青見	kuek
梗開四入青清	chek
梗開四入青曉	hek
梗合四入青曉	huek
梗開四入青徹	thr'ek
曾開三入蒸章	cjik
曾開三入蒸澄	drik
曾開三入蒸來	lik
曾開三入蒸徹	thrik
曾開三入蒸知	trik
曾開三入蒸船	zsjik
曾開三入蒸心	sik
曾開三入蒸常	zjik
曾開三入蒸書	sjik
曾開三入蒸曉	hik
曾開三入蒸崇	zrik
曾開三入蒸羣	gik
曾開三入蒸孃	nrik
曾開三入蒸初	chrik
曾開三入蒸影	qik
曾開三入蒸生	srik
曾開三入蒸溪	khik
曾開三入蒸見	kik
曾開三入蒸以	jik
曾開三入蒸精	cik
曾開三入蒸幫	pik
曾合三入蒸云	yk
曾合三入蒸曉	hyk
曾開三入蒸滂	phik
曾開三入蒸莊	crik
曾開三入蒸並	bik
曾開三入蒸疑	ngik
曾開三入蒸從	zik
曾開三入蒸知	trik
曾開三入蒸明	mik
曾開三入蒸昌	chjik
曾開一入登端	tok
曾開一入登精	cok
曾開一入登來	lok
曾開一入登透	thok
曾開一入登溪	khok
曾開一入登定	dok
曾開一入登曉	hok
曾開一入登明	mok
曾開一入登從	zok
曾開一入登心	sok
曾開一入登幫	pok
曾開一入登並	bok
曾合一入登匣	ghuok
曾合一入登見	kuok
曾開一入登影	qok
曾開一入登匣	ghok
曾開一入登泥	nok
曾開一入登見	kok
曾開一入登清	chok
曾開一入登滂	phok
曾合一入登曉	huok
深開三入侵清	chip
深開三入侵常	zjip
深開三入侵章	cjip
深開三入侵邪	zsip
深開三入侵從	zip
深開三入侵日	njip
深開三入侵影A	qjip
深開三入侵書	sjip
深開三入侵精	cip
深開三入侵羣B	gip
深開三入侵澄	drip
深開三入侵知	trip
深開三入侵來	lip
深開三入侵見B	kip
深開三入侵疑B	ngip
深開三入侵溪B	khip
深開三入侵心	sip
深開三入侵生	srip
深開三入侵曉B	hip
深開三入侵莊	crip
深開三入侵影B	qip
深開三入侵徹	thrip
深開三入侵云	ip
深開三入侵以	jip
深開三入侵孃	nrip
深開三入侵崇	zrip
深開三入侵並B	bip
深開三入侵幫B	pip
深開三入侵初	chrip
深開三入侵昌	chjip
咸開一入覃匣	ghop
咸開一入覃見	kop
咸開一入覃端	top
咸開一入覃心	sop
咸開一入覃定	dop
咸開一入覃透	thop
咸開一入覃從	zop
咸開一入覃精	cop
咸開一入覃來	lop
咸開一入覃泥	nop
咸開一入覃溪	khop
咸開一入覃影	qop
咸開一入覃曉	hop
咸開一入覃疑	ngop
咸開一入覃清	chop
咸開一入覃常	zj'op
咸開一入覃影	qop
咸開一入談匣	ghap
咸開一入談來	lap
咸開一入談端	tap
咸開一入談透	thap
咸開一入談曉	hap
咸開一入談泥	nap
咸開一入談定	dap
咸開一入談心	sap
咸開一入談疑	ngap
咸開一入談從	zap
咸開一入談見	kap
咸開一入談溪	khap
咸開一入談影	qap
咸開一入談清	chap
咸開一入談見	kap
咸開一入談章	cj'ap
咸開三入鹽以	jep
咸開三入鹽精	ciep
咸開三入鹽書	sjep
咸開三入鹽常	zjep
咸開三入鹽來	liep
咸開三入鹽從	ziep
咸開三入鹽澄	driep
咸開三入鹽影B	qiep
咸開三入鹽孃	nriep
咸開三入鹽昌	chjep
咸開三入鹽日	njep
咸開三入鹽章	cjep
咸開三入鹽清	chiep
咸開三入鹽徹	thriep
咸開三入鹽羣B	giep
咸開三入鹽知	triep
咸開三入鹽云	iep
咸開三入鹽溪A	khjep
咸開三入鹽生	sriep
咸開三入鹽見B	kiep
咸開三入鹽影A	qjep
咸開四入添透	thep
咸開四入添匣	ghep
咸開四入添見	kep
咸開四入添溪	khep
咸開四入添定	dep
咸開四入添泥	nep
咸開四入添心	sep
咸開四入添來	lep
咸開四入添端	tep
咸開四入添從	zep
咸開四入添精	cep
咸開四入添曉	hep
咸開四入添心	sep
咸開二入咸匣	ghrep
咸開二入咸溪	khrep
咸開二入咸崇	zrep
咸開二入咸見	krep
咸開二入咸莊	crep
咸開二入咸初	chrep
咸開二入咸孃	nrep
咸開二入咸曉	hrep
咸開二入咸生	srep
咸開二入咸知	trep
咸開二入咸影	qrep
咸開二入咸疑	ngrep
咸開二入咸徹	threp
咸開二入銜匣	ghrap
咸開二入銜澄	drap
咸開二入銜影	qrap
咸開二入銜見	krap
咸開二入銜生	srap
咸開二入銜曉	hrap
咸開三入嚴疑	ngiap
咸開三入嚴曉	hiap
咸開三入嚴溪	khiap
咸開三入嚴見	kiap
咸開三入嚴影	qiap
咸開三入嚴以	jap
咸開三入嚴羣	giap
咸合三入凡並	byap
咸合三入凡幫	pyap
咸合三入凡滂	phyap
咸合三入凡溪	khyap
咸合三入凡孃	nryap
咸合三入凡徹	thryap
